county_name,race_description,cand_name,precinct_code,cand_absmail_votes,cand_early_votes,cand_elecday_votes,cand_tot_votes
ADAIR,STATE QUESTION NO. 794 LEGISLATIVE REFERENDUM NO. 371,FOR THE PROPOSAL - YES,10001,3,13,178,194
ADAIR,STATE QUESTION NO. 794 LEGISLATIVE REFERENDUM NO. 371,AGAINST THE PROPOSAL - NO,10001,4,5,66,75
ADAIR,STATE QUESTION NO. 794 LEGISLATIVE REFERENDUM NO. 371,FOR THE PROPOSAL - YES,10002,5,8,159,172
ADAIR,STATE QUESTION NO. 794 LEGISLATIVE REFERENDUM NO. 371,AGAINST THE PROPOSAL - NO,10002,0,3,52,55
ADAIR,STATE QUESTION NO. 794 LEGISLATIVE REFERENDUM NO. 371,FOR THE PROPOSAL - YES,10003,6,0,87,93
ADAIR,STATE QUESTION NO. 794 LEGISLATIVE REFERENDUM NO. 371,AGAINST THE PROPOSAL - NO,10003,2,0,28,30
ADAIR,STATE QUESTION NO. 794 LEGISLATIVE REFERENDUM NO. 371,FOR THE PROPOSAL - YES,10004,9,19,140,168
ADAIR,STATE QUESTION NO. 794 LEGISLATIVE REFERENDUM NO. 371,AGAINST THE PROPOSAL - NO,10004,2,9,37,48
ADAIR,STATE QUESTION NO. 794 LEGISLATIVE REFERENDUM NO. 371,FOR THE PROPOSAL - YES,10005,7,12,123,142
ADAIR,STATE QUESTION NO. 794 LEGISLATIVE REFERENDUM NO. 371,AGAINST THE PROPOSAL - NO,10005,0,3,45,48
ADAIR,STATE QUESTION NO. 794 LEGISLATIVE REFERENDUM NO. 371,FOR THE PROPOSAL - YES,10006,5,22,265,292
ADAIR,STATE QUESTION NO. 794 LEGISLATIVE REFERENDUM NO. 371,AGAINST THE PROPOSAL - NO,10006,2,10,100,112
ADAIR,STATE QUESTION NO. 794 LEGISLATIVE REFERENDUM NO. 371,FOR THE PROPOSAL - YES,10007,5,21,284,310
ADAIR,STATE QUESTION NO. 794 LEGISLATIVE REFERENDUM NO. 371,AGAINST THE PROPOSAL - NO,10007,5,9,104,118
ADAIR,STATE QUESTION NO. 794 LEGISLATIVE REFERENDUM NO. 371,FOR THE PROPOSAL - YES,10008,3,17,212,232
ADAIR,STATE QUESTION NO. 794 LEGISLATIVE REFERENDUM NO. 371,AGAINST THE PROPOSAL - NO,10008,1,6,64,71
ADAIR,STATE QUESTION NO. 794 LEGISLATIVE REFERENDUM NO. 371,FOR THE PROPOSAL - YES,10010,0,4,69,73
ADAIR,STATE QUESTION NO. 794 LEGISLATIVE REFERENDUM NO. 371,AGAINST THE PROPOSAL - NO,10010,1,3,23,27
ADAIR,STATE QUESTION NO. 794 LEGISLATIVE REFERENDUM NO. 371,FOR THE PROPOSAL - YES,10011,4,4,81,89
ADAIR,STATE QUESTION NO. 794 LEGISLATIVE REFERENDUM NO. 371,AGAINST THE PROPOSAL - NO,10011,3,2,32,37
ADAIR,STATE QUESTION NO. 794 LEGISLATIVE REFERENDUM NO. 371,FOR THE PROPOSAL - YES,10012,5,13,200,218
ADAIR,STATE QUESTION NO. 794 LEGISLATIVE REFERENDUM NO. 371,AGAINST THE PROPOSAL - NO,10012,2,11,74,87
ADAIR,STATE QUESTION NO. 794 LEGISLATIVE REFERENDUM NO. 371,FOR THE PROPOSAL - YES,10013,11,10,168,189
ADAIR,STATE QUESTION NO. 794 LEGISLATIVE REFERENDUM NO. 371,AGAINST THE PROPOSAL - NO,10013,0,5,50,55
ADAIR,STATE QUESTION NO. 794 LEGISLATIVE REFERENDUM NO. 371,FOR THE PROPOSAL - YES,10014,8,32,257,297
ADAIR,STATE QUESTION NO. 794 LEGISLATIVE REFERENDUM NO. 371,AGAINST THE PROPOSAL - NO,10014,0,14,71,85
ADAIR,STATE QUESTION NO. 794 LEGISLATIVE REFERENDUM NO. 371,FOR THE PROPOSAL - YES,10016,8,12,222,242
ADAIR,STATE QUESTION NO. 794 LEGISLATIVE REFERENDUM NO. 371,AGAINST THE PROPOSAL - NO,10016,0,3,53,56
ADAIR,STATE QUESTION NO. 794 LEGISLATIVE REFERENDUM NO. 371,FOR THE PROPOSAL - YES,10017,3,15,337,355
ADAIR,STATE QUESTION NO. 794 LEGISLATIVE REFERENDUM NO. 371,AGAINST THE PROPOSAL - NO,10017,1,4,85,90
ADAIR,STATE QUESTION NO. 794 LEGISLATIVE REFERENDUM NO. 371,FOR THE PROPOSAL - YES,10018,7,17,299,323
ADAIR,STATE QUESTION NO. 794 LEGISLATIVE REFERENDUM NO. 371,AGAINST THE PROPOSAL - NO,10018,2,8,93,103
ADAIR,STATE QUESTION NO. 794 LEGISLATIVE REFERENDUM NO. 371,FOR THE PROPOSAL - YES,10019,12,17,386,415
ADAIR,STATE QUESTION NO. 794 LEGISLATIVE REFERENDUM NO. 371,AGAINST THE PROPOSAL - NO,10019,3,8,122,133
ALFALFA,STATE QUESTION NO. 794 LEGISLATIVE REFERENDUM NO. 371,FOR THE PROPOSAL - YES,20110,6,10,112,128
ALFALFA,STATE QUESTION NO. 794 LEGISLATIVE REFERENDUM NO. 371,AGAINST THE PROPOSAL - NO,20110,0,1,28,29
ALFALFA,STATE QUESTION NO. 794 LEGISLATIVE REFERENDUM NO. 371,FOR THE PROPOSAL - YES,20120,8,6,104,118
ALFALFA,STATE QUESTION NO. 794 LEGISLATIVE REFERENDUM NO. 371,AGAINST THE PROPOSAL - NO,20120,1,2,37,40
ALFALFA,STATE QUESTION NO. 794 LEGISLATIVE REFERENDUM NO. 371,FOR THE PROPOSAL - YES,20140,7,25,212,244
ALFALFA,STATE QUESTION NO. 794 LEGISLATIVE REFERENDUM NO. 371,AGAINST THE PROPOSAL - NO,20140,1,9,58,68
ALFALFA,STATE QUESTION NO. 794 LEGISLATIVE REFERENDUM NO. 371,FOR THE PROPOSAL - YES,20220,8,45,226,279
ALFALFA,STATE QUESTION NO. 794 LEGISLATIVE REFERENDUM NO. 371,AGAINST THE PROPOSAL - NO,20220,1,8,65,74
ALFALFA,STATE QUESTION NO. 794 LEGISLATIVE REFERENDUM NO. 371,FOR THE PROPOSAL - YES,20230,8,15,165,188
ALFALFA,STATE QUESTION NO. 794 LEGISLATIVE REFERENDUM NO. 371,AGAINST THE PROPOSAL - NO,20230,0,1,42,43
ALFALFA,STATE QUESTION NO. 794 LEGISLATIVE REFERENDUM NO. 371,FOR THE PROPOSAL - YES,20310,7,8,195,210
ALFALFA,STATE QUESTION NO. 794 LEGISLATIVE REFERENDUM NO. 371,AGAINST THE PROPOSAL - NO,20310,3,4,67,74
ALFALFA,STATE QUESTION NO. 794 LEGISLATIVE REFERENDUM NO. 371,FOR THE PROPOSAL - YES,20320,4,2,103,109
ALFALFA,STATE QUESTION NO. 794 LEGISLATIVE REFERENDUM NO. 371,AGAINST THE PROPOSAL - NO,20320,1,0,25,26
ALFALFA,STATE QUESTION NO. 794 LEGISLATIVE REFERENDUM NO. 371,FOR THE PROPOSAL - YES,20330,1,5,120,126
ALFALFA,STATE QUESTION NO. 794 LEGISLATIVE REFERENDUM NO. 371,AGAINST THE PROPOSAL - NO,20330,0,4,21,25
ATOKA,STATE QUESTION NO. 794 LEGISLATIVE REFERENDUM NO. 371,FOR THE PROPOSAL - YES,30001,4,81,241,326
ATOKA,STATE QUESTION NO. 794 LEGISLATIVE REFERENDUM NO. 371,AGAINST THE PROPOSAL - NO,30001,2,17,68,87
ATOKA,STATE QUESTION NO. 794 LEGISLATIVE REFERENDUM NO. 371,FOR THE PROPOSAL - YES,30002,11,55,196,262
ATOKA,STATE QUESTION NO. 794 LEGISLATIVE REFERENDUM NO. 371,AGAINST THE PROPOSAL - NO,30002,4,15,42,61
ATOKA,STATE QUESTION NO. 794 LEGISLATIVE REFERENDUM NO. 371,FOR THE PROPOSAL - YES,30003,5,51,137,193
ATOKA,STATE QUESTION NO. 794 LEGISLATIVE REFERENDUM NO. 371,AGAINST THE PROPOSAL - NO,30003,2,8,44,54
ATOKA,STATE QUESTION NO. 794 LEGISLATIVE REFERENDUM NO. 371,FOR THE PROPOSAL - YES,30006,9,45,120,174
ATOKA,STATE QUESTION NO. 794 LEGISLATIVE REFERENDUM NO. 371,AGAINST THE PROPOSAL - NO,30006,1,16,32,49
ATOKA,STATE QUESTION NO. 794 LEGISLATIVE REFERENDUM NO. 371,FOR THE PROPOSAL - YES,30007,6,40,246,292
ATOKA,STATE QUESTION NO. 794 LEGISLATIVE REFERENDUM NO. 371,AGAINST THE PROPOSAL - NO,30007,3,4,68,75
ATOKA,STATE QUESTION NO. 794 LEGISLATIVE REFERENDUM NO. 371,FOR THE PROPOSAL - YES,30008,14,56,394,464
ATOKA,STATE QUESTION NO. 794 LEGISLATIVE REFERENDUM NO. 371,AGAINST THE PROPOSAL - NO,30008,3,11,124,138
ATOKA,STATE QUESTION NO. 794 LEGISLATIVE REFERENDUM NO. 371,FOR THE PROPOSAL - YES,30009,13,60,197,270
ATOKA,STATE QUESTION NO. 794 LEGISLATIVE REFERENDUM NO. 371,AGAINST THE PROPOSAL - NO,30009,2,14,48,64
ATOKA,STATE QUESTION NO. 794 LEGISLATIVE REFERENDUM NO. 371,FOR THE PROPOSAL - YES,30010,3,4,70,77
ATOKA,STATE QUESTION NO. 794 LEGISLATIVE REFERENDUM NO. 371,AGAINST THE PROPOSAL - NO,30010,0,1,26,27
ATOKA,STATE QUESTION NO. 794 LEGISLATIVE REFERENDUM NO. 371,FOR THE PROPOSAL - YES,30011,7,130,313,450
ATOKA,STATE QUESTION NO. 794 LEGISLATIVE REFERENDUM NO. 371,AGAINST THE PROPOSAL - NO,30011,1,35,128,164
ATOKA,STATE QUESTION NO. 794 LEGISLATIVE REFERENDUM NO. 371,FOR THE PROPOSAL - YES,30012,1,22,169,192
ATOKA,STATE QUESTION NO. 794 LEGISLATIVE REFERENDUM NO. 371,AGAINST THE PROPOSAL - NO,30012,0,4,50,54
ATOKA,STATE QUESTION NO. 794 LEGISLATIVE REFERENDUM NO. 371,FOR THE PROPOSAL - YES,30013,5,8,164,177
ATOKA,STATE QUESTION NO. 794 LEGISLATIVE REFERENDUM NO. 371,AGAINST THE PROPOSAL - NO,30013,2,6,50,58
ATOKA,STATE QUESTION NO. 794 LEGISLATIVE REFERENDUM NO. 371,FOR THE PROPOSAL - YES,30014,1,0,62,63
ATOKA,STATE QUESTION NO. 794 LEGISLATIVE REFERENDUM NO. 371,AGAINST THE PROPOSAL - NO,30014,0,2,30,32
ATOKA,STATE QUESTION NO. 794 LEGISLATIVE REFERENDUM NO. 371,FOR THE PROPOSAL - YES,30015,0,7,43,50
ATOKA,STATE QUESTION NO. 794 LEGISLATIVE REFERENDUM NO. 371,AGAINST THE PROPOSAL - NO,30015,0,1,14,15
ATOKA,STATE QUESTION NO. 794 LEGISLATIVE REFERENDUM NO. 371,FOR THE PROPOSAL - YES,30016,0,0,0,0
ATOKA,STATE QUESTION NO. 794 LEGISLATIVE REFERENDUM NO. 371,AGAINST THE PROPOSAL - NO,30016,0,0,0,0
ATOKA,STATE QUESTION NO. 794 LEGISLATIVE REFERENDUM NO. 371,FOR THE PROPOSAL - YES,30017,0,0,0,0
ATOKA,STATE QUESTION NO. 794 LEGISLATIVE REFERENDUM NO. 371,AGAINST THE PROPOSAL - NO,30017,0,0,0,0
ATOKA,STATE QUESTION NO. 794 LEGISLATIVE REFERENDUM NO. 371,FOR THE PROPOSAL - YES,30018,0,0,0,0
ATOKA,STATE QUESTION NO. 794 LEGISLATIVE REFERENDUM NO. 371,AGAINST THE PROPOSAL - NO,30018,0,0,0,0
ATOKA,STATE QUESTION NO. 794 LEGISLATIVE REFERENDUM NO. 371,FOR THE PROPOSAL - YES,30019,1,0,14,15
ATOKA,STATE QUESTION NO. 794 LEGISLATIVE REFERENDUM NO. 371,AGAINST THE PROPOSAL - NO,30019,0,0,6,6
BEAVER,STATE QUESTION NO. 794 LEGISLATIVE REFERENDUM NO. 371,FOR THE PROPOSAL - YES,40011,6,10,92,108
BEAVER,STATE QUESTION NO. 794 LEGISLATIVE REFERENDUM NO. 371,AGAINST THE PROPOSAL - NO,40011,4,4,42,50
BEAVER,STATE QUESTION NO. 794 LEGISLATIVE REFERENDUM NO. 371,FOR THE PROPOSAL - YES,40013,8,4,63,75
BEAVER,STATE QUESTION NO. 794 LEGISLATIVE REFERENDUM NO. 371,AGAINST THE PROPOSAL - NO,40013,2,2,26,30
BEAVER,STATE QUESTION NO. 794 LEGISLATIVE REFERENDUM NO. 371,FOR THE PROPOSAL - YES,40023,27,93,316,436
BEAVER,STATE QUESTION NO. 794 LEGISLATIVE REFERENDUM NO. 371,AGAINST THE PROPOSAL - NO,40023,12,46,143,201
BEAVER,STATE QUESTION NO. 794 LEGISLATIVE REFERENDUM NO. 371,FOR THE PROPOSAL - YES,40025,3,6,100,109
BEAVER,STATE QUESTION NO. 794 LEGISLATIVE REFERENDUM NO. 371,AGAINST THE PROPOSAL - NO,40025,2,5,31,38
BEAVER,STATE QUESTION NO. 794 LEGISLATIVE REFERENDUM NO. 371,FOR THE PROPOSAL - YES,40026,0,3,28,31
BEAVER,STATE QUESTION NO. 794 LEGISLATIVE REFERENDUM NO. 371,AGAINST THE PROPOSAL - NO,40026,2,1,9,12
BEAVER,STATE QUESTION NO. 794 LEGISLATIVE REFERENDUM NO. 371,FOR THE PROPOSAL - YES,40031,5,11,121,137
BEAVER,STATE QUESTION NO. 794 LEGISLATIVE REFERENDUM NO. 371,AGAINST THE PROPOSAL - NO,40031,2,6,62,70
BEAVER,STATE QUESTION NO. 794 LEGISLATIVE REFERENDUM NO. 371,FOR THE PROPOSAL - YES,40033,17,11,255,283
BEAVER,STATE QUESTION NO. 794 LEGISLATIVE REFERENDUM NO. 371,AGAINST THE PROPOSAL - NO,40033,5,7,163,175
BECKHAM,STATE QUESTION NO. 794 LEGISLATIVE REFERENDUM NO. 371,FOR THE PROPOSAL - YES,50111,15,63,389,467
BECKHAM,STATE QUESTION NO. 794 LEGISLATIVE REFERENDUM NO. 371,AGAINST THE PROPOSAL - NO,50111,1,24,102,127
BECKHAM,STATE QUESTION NO. 794 LEGISLATIVE REFERENDUM NO. 371,FOR THE PROPOSAL - YES,50112,7,12,178,197
BECKHAM,STATE QUESTION NO. 794 LEGISLATIVE REFERENDUM NO. 371,AGAINST THE PROPOSAL - NO,50112,0,10,64,74
BECKHAM,STATE QUESTION NO. 794 LEGISLATIVE REFERENDUM NO. 371,FOR THE PROPOSAL - YES,50115,4,33,58,95
BECKHAM,STATE QUESTION NO. 794 LEGISLATIVE REFERENDUM NO. 371,AGAINST THE PROPOSAL - NO,50115,1,9,16,26
BECKHAM,STATE QUESTION NO. 794 LEGISLATIVE REFERENDUM NO. 371,FOR THE PROPOSAL - YES,50141,17,30,385,432
BECKHAM,STATE QUESTION NO. 794 LEGISLATIVE REFERENDUM NO. 371,AGAINST THE PROPOSAL - NO,50141,4,4,105,113
BECKHAM,STATE QUESTION NO. 794 LEGISLATIVE REFERENDUM NO. 371,FOR THE PROPOSAL - YES,50231,3,10,203,216
BECKHAM,STATE QUESTION NO. 794 LEGISLATIVE REFERENDUM NO. 371,AGAINST THE PROPOSAL - NO,50231,4,1,69,74
BECKHAM,STATE QUESTION NO. 794 LEGISLATIVE REFERENDUM NO. 371,FOR THE PROPOSAL - YES,50232,4,1,58,63
BECKHAM,STATE QUESTION NO. 794 LEGISLATIVE REFERENDUM NO. 371,AGAINST THE PROPOSAL - NO,50232,0,1,18,19
BECKHAM,STATE QUESTION NO. 794 LEGISLATIVE REFERENDUM NO. 371,FOR THE PROPOSAL - YES,50235,32,80,900,1012
BECKHAM,STATE QUESTION NO. 794 LEGISLATIVE REFERENDUM NO. 371,AGAINST THE PROPOSAL - NO,50235,8,7,247,262
BECKHAM,STATE QUESTION NO. 794 LEGISLATIVE REFERENDUM NO. 371,FOR THE PROPOSAL - YES,50242,4,7,176,187
BECKHAM,STATE QUESTION NO. 794 LEGISLATIVE REFERENDUM NO. 371,AGAINST THE PROPOSAL - NO,50242,1,3,28,32
BECKHAM,STATE QUESTION NO. 794 LEGISLATIVE REFERENDUM NO. 371,FOR THE PROPOSAL - YES,50320,13,18,254,285
BECKHAM,STATE QUESTION NO. 794 LEGISLATIVE REFERENDUM NO. 371,AGAINST THE PROPOSAL - NO,50320,0,2,67,69
BECKHAM,STATE QUESTION NO. 794 LEGISLATIVE REFERENDUM NO. 371,FOR THE PROPOSAL - YES,50330,9,24,201,234
BECKHAM,STATE QUESTION NO. 794 LEGISLATIVE REFERENDUM NO. 371,AGAINST THE PROPOSAL - NO,50330,1,2,63,66
BECKHAM,STATE QUESTION NO. 794 LEGISLATIVE REFERENDUM NO. 371,FOR THE PROPOSAL - YES,50332,19,24,556,599
BECKHAM,STATE QUESTION NO. 794 LEGISLATIVE REFERENDUM NO. 371,AGAINST THE PROPOSAL - NO,50332,6,5,154,165
BECKHAM,STATE QUESTION NO. 794 LEGISLATIVE REFERENDUM NO. 371,FOR THE PROPOSAL - YES,50333,30,25,447,502
BECKHAM,STATE QUESTION NO. 794 LEGISLATIVE REFERENDUM NO. 371,AGAINST THE PROPOSAL - NO,50333,8,5,137,150
BECKHAM,STATE QUESTION NO. 794 LEGISLATIVE REFERENDUM NO. 371,FOR THE PROPOSAL - YES,50343,5,26,87,118
BECKHAM,STATE QUESTION NO. 794 LEGISLATIVE REFERENDUM NO. 371,AGAINST THE PROPOSAL - NO,50343,3,6,20,29
BLAINE,STATE QUESTION NO. 794 LEGISLATIVE REFERENDUM NO. 371,FOR THE PROPOSAL - YES,60002,12,12,405,429
BLAINE,STATE QUESTION NO. 794 LEGISLATIVE REFERENDUM NO. 371,AGAINST THE PROPOSAL - NO,60002,4,1,90,95
BLAINE,STATE QUESTION NO. 794 LEGISLATIVE REFERENDUM NO. 371,FOR THE PROPOSAL - YES,60007,7,14,345,366
BLAINE,STATE QUESTION NO. 794 LEGISLATIVE REFERENDUM NO. 371,AGAINST THE PROPOSAL - NO,60007,9,5,82,96
BLAINE,STATE QUESTION NO. 794 LEGISLATIVE REFERENDUM NO. 371,FOR THE PROPOSAL - YES,60010,8,26,182,216
BLAINE,STATE QUESTION NO. 794 LEGISLATIVE REFERENDUM NO. 371,AGAINST THE PROPOSAL - NO,60010,3,4,30,37
BLAINE,STATE QUESTION NO. 794 LEGISLATIVE REFERENDUM NO. 371,FOR THE PROPOSAL - YES,60011,4,17,140,161
BLAINE,STATE QUESTION NO. 794 LEGISLATIVE REFERENDUM NO. 371,AGAINST THE PROPOSAL - NO,60011,2,5,22,29
BLAINE,STATE QUESTION NO. 794 LEGISLATIVE REFERENDUM NO. 371,FOR THE PROPOSAL - YES,60012,40,78,466,584
BLAINE,STATE QUESTION NO. 794 LEGISLATIVE REFERENDUM NO. 371,AGAINST THE PROPOSAL - NO,60012,5,18,110,133
BLAINE,STATE QUESTION NO. 794 LEGISLATIVE REFERENDUM NO. 371,FOR THE PROPOSAL - YES,60016,1,15,92,108
BLAINE,STATE QUESTION NO. 794 LEGISLATIVE REFERENDUM NO. 371,AGAINST THE PROPOSAL - NO,60016,0,1,11,12
BLAINE,STATE QUESTION NO. 794 LEGISLATIVE REFERENDUM NO. 371,FOR THE PROPOSAL - YES,60017,9,13,288,310
BLAINE,STATE QUESTION NO. 794 LEGISLATIVE REFERENDUM NO. 371,AGAINST THE PROPOSAL - NO,60017,0,5,52,57
BLAINE,STATE QUESTION NO. 794 LEGISLATIVE REFERENDUM NO. 371,FOR THE PROPOSAL - YES,60020,8,0,166,174
BLAINE,STATE QUESTION NO. 794 LEGISLATIVE REFERENDUM NO. 371,AGAINST THE PROPOSAL - NO,60020,3,1,48,52
BLAINE,STATE QUESTION NO. 794 LEGISLATIVE REFERENDUM NO. 371,FOR THE PROPOSAL - YES,60022,0,3,33,36
BLAINE,STATE QUESTION NO. 794 LEGISLATIVE REFERENDUM NO. 371,AGAINST THE PROPOSAL - NO,60022,0,0,9,9
BRYAN,STATE QUESTION NO. 794 LEGISLATIVE REFERENDUM NO. 371,FOR THE PROPOSAL - YES,70003,21,42,334,397
BRYAN,STATE QUESTION NO. 794 LEGISLATIVE REFERENDUM NO. 371,AGAINST THE PROPOSAL - NO,70003,2,16,114,132
BRYAN,STATE QUESTION NO. 794 LEGISLATIVE REFERENDUM NO. 371,FOR THE PROPOSAL - YES,70004,9,61,389,459
BRYAN,STATE QUESTION NO. 794 LEGISLATIVE REFERENDUM NO. 371,AGAINST THE PROPOSAL - NO,70004,10,13,86,109
BRYAN,STATE QUESTION NO. 794 LEGISLATIVE REFERENDUM NO. 371,FOR THE PROPOSAL - YES,70005,17,51,407,475
BRYAN,STATE QUESTION NO. 794 LEGISLATIVE REFERENDUM NO. 371,AGAINST THE PROPOSAL - NO,70005,9,22,134,165
BRYAN,STATE QUESTION NO. 794 LEGISLATIVE REFERENDUM NO. 371,FOR THE PROPOSAL - YES,70008,25,74,450,549
BRYAN,STATE QUESTION NO. 794 LEGISLATIVE REFERENDUM NO. 371,AGAINST THE PROPOSAL - NO,70008,9,18,110,137
BRYAN,STATE QUESTION NO. 794 LEGISLATIVE REFERENDUM NO. 371,FOR THE PROPOSAL - YES,70010,4,33,249,286
BRYAN,STATE QUESTION NO. 794 LEGISLATIVE REFERENDUM NO. 371,AGAINST THE PROPOSAL - NO,70010,5,2,69,76
BRYAN,STATE QUESTION NO. 794 LEGISLATIVE REFERENDUM NO. 371,FOR THE PROPOSAL - YES,70011,3,2,108,113
BRYAN,STATE QUESTION NO. 794 LEGISLATIVE REFERENDUM NO. 371,AGAINST THE PROPOSAL - NO,70011,0,2,27,29
BRYAN,STATE QUESTION NO. 794 LEGISLATIVE REFERENDUM NO. 371,FOR THE PROPOSAL - YES,70013,10,9,282,301
BRYAN,STATE QUESTION NO. 794 LEGISLATIVE REFERENDUM NO. 371,AGAINST THE PROPOSAL - NO,70013,0,3,103,106
BRYAN,STATE QUESTION NO. 794 LEGISLATIVE REFERENDUM NO. 371,FOR THE PROPOSAL - YES,70014,2,23,175,200
BRYAN,STATE QUESTION NO. 794 LEGISLATIVE REFERENDUM NO. 371,AGAINST THE PROPOSAL - NO,70014,0,7,43,50
BRYAN,STATE QUESTION NO. 794 LEGISLATIVE REFERENDUM NO. 371,FOR THE PROPOSAL - YES,70015,10,24,323,357
BRYAN,STATE QUESTION NO. 794 LEGISLATIVE REFERENDUM NO. 371,AGAINST THE PROPOSAL - NO,70015,5,12,99,116
BRYAN,STATE QUESTION NO. 794 LEGISLATIVE REFERENDUM NO. 371,FOR THE PROPOSAL - YES,70017,1,7,253,261
BRYAN,STATE QUESTION NO. 794 LEGISLATIVE REFERENDUM NO. 371,AGAINST THE PROPOSAL - NO,70017,1,1,61,63
BRYAN,STATE QUESTION NO. 794 LEGISLATIVE REFERENDUM NO. 371,FOR THE PROPOSAL - YES,70018,20,44,473,537
BRYAN,STATE QUESTION NO. 794 LEGISLATIVE REFERENDUM NO. 371,AGAINST THE PROPOSAL - NO,70018,2,12,142,156
BRYAN,STATE QUESTION NO. 794 LEGISLATIVE REFERENDUM NO. 371,FOR THE PROPOSAL - YES,70019,12,34,368,414
BRYAN,STATE QUESTION NO. 794 LEGISLATIVE REFERENDUM NO. 371,AGAINST THE PROPOSAL - NO,70019,2,18,115,135
BRYAN,STATE QUESTION NO. 794 LEGISLATIVE REFERENDUM NO. 371,FOR THE PROPOSAL - YES,70020,11,8,335,354
BRYAN,STATE QUESTION NO. 794 LEGISLATIVE REFERENDUM NO. 371,AGAINST THE PROPOSAL - NO,70020,6,10,66,82
BRYAN,STATE QUESTION NO. 794 LEGISLATIVE REFERENDUM NO. 371,FOR THE PROPOSAL - YES,70021,5,30,346,381
BRYAN,STATE QUESTION NO. 794 LEGISLATIVE REFERENDUM NO. 371,AGAINST THE PROPOSAL - NO,70021,5,20,107,132
BRYAN,STATE QUESTION NO. 794 LEGISLATIVE REFERENDUM NO. 371,FOR THE PROPOSAL - YES,70022,10,38,502,550
BRYAN,STATE QUESTION NO. 794 LEGISLATIVE REFERENDUM NO. 371,AGAINST THE PROPOSAL - NO,70022,2,4,99,105
BRYAN,STATE QUESTION NO. 794 LEGISLATIVE REFERENDUM NO. 371,FOR THE PROPOSAL - YES,70023,1,5,198,204
BRYAN,STATE QUESTION NO. 794 LEGISLATIVE REFERENDUM NO. 371,AGAINST THE PROPOSAL - NO,70023,1,1,49,51
BRYAN,STATE QUESTION NO. 794 LEGISLATIVE REFERENDUM NO. 371,FOR THE PROPOSAL - YES,70025,17,61,489,567
BRYAN,STATE QUESTION NO. 794 LEGISLATIVE REFERENDUM NO. 371,AGAINST THE PROPOSAL - NO,70025,6,14,114,134
BRYAN,STATE QUESTION NO. 794 LEGISLATIVE REFERENDUM NO. 371,FOR THE PROPOSAL - YES,70026,12,30,274,316
BRYAN,STATE QUESTION NO. 794 LEGISLATIVE REFERENDUM NO. 371,AGAINST THE PROPOSAL - NO,70026,1,11,87,99
BRYAN,STATE QUESTION NO. 794 LEGISLATIVE REFERENDUM NO. 371,FOR THE PROPOSAL - YES,70027,11,56,450,517
BRYAN,STATE QUESTION NO. 794 LEGISLATIVE REFERENDUM NO. 371,AGAINST THE PROPOSAL - NO,70027,5,16,129,150
BRYAN,STATE QUESTION NO. 794 LEGISLATIVE REFERENDUM NO. 371,FOR THE PROPOSAL - YES,70028,9,30,337,376
BRYAN,STATE QUESTION NO. 794 LEGISLATIVE REFERENDUM NO. 371,AGAINST THE PROPOSAL - NO,70028,1,8,102,111
BRYAN,STATE QUESTION NO. 794 LEGISLATIVE REFERENDUM NO. 371,FOR THE PROPOSAL - YES,70029,0,2,111,113
BRYAN,STATE QUESTION NO. 794 LEGISLATIVE REFERENDUM NO. 371,AGAINST THE PROPOSAL - NO,70029,0,3,25,28
BRYAN,STATE QUESTION NO. 794 LEGISLATIVE REFERENDUM NO. 371,FOR THE PROPOSAL - YES,70033,39,140,690,869
BRYAN,STATE QUESTION NO. 794 LEGISLATIVE REFERENDUM NO. 371,AGAINST THE PROPOSAL - NO,70033,11,31,218,260
CADDO,STATE QUESTION NO. 794 LEGISLATIVE REFERENDUM NO. 371,FOR THE PROPOSAL - YES,80012,5,8,191,204
CADDO,STATE QUESTION NO. 794 LEGISLATIVE REFERENDUM NO. 371,AGAINST THE PROPOSAL - NO,80012,0,2,47,49
CADDO,STATE QUESTION NO. 794 LEGISLATIVE REFERENDUM NO. 371,FOR THE PROPOSAL - YES,80022,5,19,214,238
CADDO,STATE QUESTION NO. 794 LEGISLATIVE REFERENDUM NO. 371,AGAINST THE PROPOSAL - NO,80022,2,9,50,61
CADDO,STATE QUESTION NO. 794 LEGISLATIVE REFERENDUM NO. 371,FOR THE PROPOSAL - YES,80031,2,7,153,162
CADDO,STATE QUESTION NO. 794 LEGISLATIVE REFERENDUM NO. 371,AGAINST THE PROPOSAL - NO,80031,0,6,32,38
CADDO,STATE QUESTION NO. 794 LEGISLATIVE REFERENDUM NO. 371,FOR THE PROPOSAL - YES,80041,14,44,386,444
CADDO,STATE QUESTION NO. 794 LEGISLATIVE REFERENDUM NO. 371,AGAINST THE PROPOSAL - NO,80041,1,20,93,114
CADDO,STATE QUESTION NO. 794 LEGISLATIVE REFERENDUM NO. 371,FOR THE PROPOSAL - YES,80051,10,66,536,612
CADDO,STATE QUESTION NO. 794 LEGISLATIVE REFERENDUM NO. 371,AGAINST THE PROPOSAL - NO,80051,4,26,118,148
CADDO,STATE QUESTION NO. 794 LEGISLATIVE REFERENDUM NO. 371,FOR THE PROPOSAL - YES,80102,23,13,483,519
CADDO,STATE QUESTION NO. 794 LEGISLATIVE REFERENDUM NO. 371,AGAINST THE PROPOSAL - NO,80102,4,5,120,129
CADDO,STATE QUESTION NO. 794 LEGISLATIVE REFERENDUM NO. 371,FOR THE PROPOSAL - YES,80509,4,12,227,243
CADDO,STATE QUESTION NO. 794 LEGISLATIVE REFERENDUM NO. 371,AGAINST THE PROPOSAL - NO,80509,0,2,54,56
CADDO,STATE QUESTION NO. 794 LEGISLATIVE REFERENDUM NO. 371,FOR THE PROPOSAL - YES,80510,12,21,356,389
CADDO,STATE QUESTION NO. 794 LEGISLATIVE REFERENDUM NO. 371,AGAINST THE PROPOSAL - NO,80510,2,5,104,111
CADDO,STATE QUESTION NO. 794 LEGISLATIVE REFERENDUM NO. 371,FOR THE PROPOSAL - YES,80511,11,19,525,555
CADDO,STATE QUESTION NO. 794 LEGISLATIVE REFERENDUM NO. 371,AGAINST THE PROPOSAL - NO,80511,10,2,114,126
CADDO,STATE QUESTION NO. 794 LEGISLATIVE REFERENDUM NO. 371,FOR THE PROPOSAL - YES,80712,5,8,291,304
CADDO,STATE QUESTION NO. 794 LEGISLATIVE REFERENDUM NO. 371,AGAINST THE PROPOSAL - NO,80712,2,5,89,96
CADDO,STATE QUESTION NO. 794 LEGISLATIVE REFERENDUM NO. 371,FOR THE PROPOSAL - YES,80715,2,4,60,66
CADDO,STATE QUESTION NO. 794 LEGISLATIVE REFERENDUM NO. 371,AGAINST THE PROPOSAL - NO,80715,0,2,21,23
CADDO,STATE QUESTION NO. 794 LEGISLATIVE REFERENDUM NO. 371,FOR THE PROPOSAL - YES,80810,5,10,114,129
CADDO,STATE QUESTION NO. 794 LEGISLATIVE REFERENDUM NO. 371,AGAINST THE PROPOSAL - NO,80810,2,2,34,38
CADDO,STATE QUESTION NO. 794 LEGISLATIVE REFERENDUM NO. 371,FOR THE PROPOSAL - YES,80811,10,25,173,208
CADDO,STATE QUESTION NO. 794 LEGISLATIVE REFERENDUM NO. 371,AGAINST THE PROPOSAL - NO,80811,0,6,44,50
CADDO,STATE QUESTION NO. 794 LEGISLATIVE REFERENDUM NO. 371,FOR THE PROPOSAL - YES,80812,7,7,131,145
CADDO,STATE QUESTION NO. 794 LEGISLATIVE REFERENDUM NO. 371,AGAINST THE PROPOSAL - NO,80812,3,1,26,30
CADDO,STATE QUESTION NO. 794 LEGISLATIVE REFERENDUM NO. 371,FOR THE PROPOSAL - YES,81009,4,9,154,167
CADDO,STATE QUESTION NO. 794 LEGISLATIVE REFERENDUM NO. 371,AGAINST THE PROPOSAL - NO,81009,2,3,39,44
CADDO,STATE QUESTION NO. 794 LEGISLATIVE REFERENDUM NO. 371,FOR THE PROPOSAL - YES,81010,8,13,262,283
CADDO,STATE QUESTION NO. 794 LEGISLATIVE REFERENDUM NO. 371,AGAINST THE PROPOSAL - NO,81010,1,4,50,55
CADDO,STATE QUESTION NO. 794 LEGISLATIVE REFERENDUM NO. 371,FOR THE PROPOSAL - YES,81011,6,2,193,201
CADDO,STATE QUESTION NO. 794 LEGISLATIVE REFERENDUM NO. 371,AGAINST THE PROPOSAL - NO,81011,1,0,46,47
CADDO,STATE QUESTION NO. 794 LEGISLATIVE REFERENDUM NO. 371,FOR THE PROPOSAL - YES,81013,26,0,161,187
CADDO,STATE QUESTION NO. 794 LEGISLATIVE REFERENDUM NO. 371,AGAINST THE PROPOSAL - NO,81013,4,0,48,52
CADDO,STATE QUESTION NO. 794 LEGISLATIVE REFERENDUM NO. 371,FOR THE PROPOSAL - YES,81111,9,7,510,526
CADDO,STATE QUESTION NO. 794 LEGISLATIVE REFERENDUM NO. 371,AGAINST THE PROPOSAL - NO,81111,3,3,129,135
CADDO,STATE QUESTION NO. 794 LEGISLATIVE REFERENDUM NO. 371,FOR THE PROPOSAL - YES,81213,8,0,162,170
CADDO,STATE QUESTION NO. 794 LEGISLATIVE REFERENDUM NO. 371,AGAINST THE PROPOSAL - NO,81213,2,0,42,44
CANADIAN,STATE QUESTION NO. 794 LEGISLATIVE REFERENDUM NO. 371,FOR THE PROPOSAL - YES,90100,11,62,456,529
CANADIAN,STATE QUESTION NO. 794 LEGISLATIVE REFERENDUM NO. 371,AGAINST THE PROPOSAL - NO,90100,2,15,106,123
CANADIAN,STATE QUESTION NO. 794 LEGISLATIVE REFERENDUM NO. 371,FOR THE PROPOSAL - YES,90102,1,12,112,125
CANADIAN,STATE QUESTION NO. 794 LEGISLATIVE REFERENDUM NO. 371,AGAINST THE PROPOSAL - NO,90102,2,4,32,38
CANADIAN,STATE QUESTION NO. 794 LEGISLATIVE REFERENDUM NO. 371,FOR THE PROPOSAL - YES,90106,25,92,504,621
CANADIAN,STATE QUESTION NO. 794 LEGISLATIVE REFERENDUM NO. 371,AGAINST THE PROPOSAL - NO,90106,4,16,119,139
CANADIAN,STATE QUESTION NO. 794 LEGISLATIVE REFERENDUM NO. 371,FOR THE PROPOSAL - YES,90107,4,26,206,236
CANADIAN,STATE QUESTION NO. 794 LEGISLATIVE REFERENDUM NO. 371,AGAINST THE PROPOSAL - NO,90107,1,4,58,63
CANADIAN,STATE QUESTION NO. 794 LEGISLATIVE REFERENDUM NO. 371,FOR THE PROPOSAL - YES,90109,4,16,86,106
CANADIAN,STATE QUESTION NO. 794 LEGISLATIVE REFERENDUM NO. 371,AGAINST THE PROPOSAL - NO,90109,2,3,17,22
CANADIAN,STATE QUESTION NO. 794 LEGISLATIVE REFERENDUM NO. 371,FOR THE PROPOSAL - YES,90114,36,51,396,483
CANADIAN,STATE QUESTION NO. 794 LEGISLATIVE REFERENDUM NO. 371,AGAINST THE PROPOSAL - NO,90114,1,9,80,90
CANADIAN,STATE QUESTION NO. 794 LEGISLATIVE REFERENDUM NO. 371,FOR THE PROPOSAL - YES,90116,17,96,533,646
CANADIAN,STATE QUESTION NO. 794 LEGISLATIVE REFERENDUM NO. 371,AGAINST THE PROPOSAL - NO,90116,9,17,117,143
CANADIAN,STATE QUESTION NO. 794 LEGISLATIVE REFERENDUM NO. 371,FOR THE PROPOSAL - YES,90124,25,104,651,780
CANADIAN,STATE QUESTION NO. 794 LEGISLATIVE REFERENDUM NO. 371,AGAINST THE PROPOSAL - NO,90124,2,14,150,166
CANADIAN,STATE QUESTION NO. 794 LEGISLATIVE REFERENDUM NO. 371,FOR THE PROPOSAL - YES,90200,252,116,2167,2535
CANADIAN,STATE QUESTION NO. 794 LEGISLATIVE REFERENDUM NO. 371,AGAINST THE PROPOSAL - NO,90200,63,26,679,768
CANADIAN,STATE QUESTION NO. 794 LEGISLATIVE REFERENDUM NO. 371,FOR THE PROPOSAL - YES,90201,56,37,687,780
CANADIAN,STATE QUESTION NO. 794 LEGISLATIVE REFERENDUM NO. 371,AGAINST THE PROPOSAL - NO,90201,16,6,167,189
CANADIAN,STATE QUESTION NO. 794 LEGISLATIVE REFERENDUM NO. 371,FOR THE PROPOSAL - YES,90202,21,21,301,343
CANADIAN,STATE QUESTION NO. 794 LEGISLATIVE REFERENDUM NO. 371,AGAINST THE PROPOSAL - NO,90202,4,3,52,59
CANADIAN,STATE QUESTION NO. 794 LEGISLATIVE REFERENDUM NO. 371,FOR THE PROPOSAL - YES,90204,59,53,727,839
CANADIAN,STATE QUESTION NO. 794 LEGISLATIVE REFERENDUM NO. 371,AGAINST THE PROPOSAL - NO,90204,16,5,183,204
CANADIAN,STATE QUESTION NO. 794 LEGISLATIVE REFERENDUM NO. 371,FOR THE PROPOSAL - YES,90206,58,40,956,1054
CANADIAN,STATE QUESTION NO. 794 LEGISLATIVE REFERENDUM NO. 371,AGAINST THE PROPOSAL - NO,90206,14,11,236,261
CANADIAN,STATE QUESTION NO. 794 LEGISLATIVE REFERENDUM NO. 371,FOR THE PROPOSAL - YES,90208,58,22,745,825
CANADIAN,STATE QUESTION NO. 794 LEGISLATIVE REFERENDUM NO. 371,AGAINST THE PROPOSAL - NO,90208,17,11,197,225
CANADIAN,STATE QUESTION NO. 794 LEGISLATIVE REFERENDUM NO. 371,FOR THE PROPOSAL - YES,90209,3,1,23,27
CANADIAN,STATE QUESTION NO. 794 LEGISLATIVE REFERENDUM NO. 371,AGAINST THE PROPOSAL - NO,90209,0,0,14,14
CANADIAN,STATE QUESTION NO. 794 LEGISLATIVE REFERENDUM NO. 371,FOR THE PROPOSAL - YES,90210,31,35,392,458
CANADIAN,STATE QUESTION NO. 794 LEGISLATIVE REFERENDUM NO. 371,AGAINST THE PROPOSAL - NO,90210,8,10,96,114
CANADIAN,STATE QUESTION NO. 794 LEGISLATIVE REFERENDUM NO. 371,FOR THE PROPOSAL - YES,90211,52,21,550,623
CANADIAN,STATE QUESTION NO. 794 LEGISLATIVE REFERENDUM NO. 371,AGAINST THE PROPOSAL - NO,90211,13,10,140,163
CANADIAN,STATE QUESTION NO. 794 LEGISLATIVE REFERENDUM NO. 371,FOR THE PROPOSAL - YES,90214,46,39,723,808
CANADIAN,STATE QUESTION NO. 794 LEGISLATIVE REFERENDUM NO. 371,AGAINST THE PROPOSAL - NO,90214,14,10,196,220
CANADIAN,STATE QUESTION NO. 794 LEGISLATIVE REFERENDUM NO. 371,FOR THE PROPOSAL - YES,90215,107,72,975,1154
CANADIAN,STATE QUESTION NO. 794 LEGISLATIVE REFERENDUM NO. 371,AGAINST THE PROPOSAL - NO,90215,24,7,285,316
CANADIAN,STATE QUESTION NO. 794 LEGISLATIVE REFERENDUM NO. 371,FOR THE PROPOSAL - YES,90216,125,84,1052,1261
CANADIAN,STATE QUESTION NO. 794 LEGISLATIVE REFERENDUM NO. 371,AGAINST THE PROPOSAL - NO,90216,23,11,245,279
CANADIAN,STATE QUESTION NO. 794 LEGISLATIVE REFERENDUM NO. 371,FOR THE PROPOSAL - YES,90217,103,71,1090,1264
CANADIAN,STATE QUESTION NO. 794 LEGISLATIVE REFERENDUM NO. 371,AGAINST THE PROPOSAL - NO,90217,22,10,262,294
CANADIAN,STATE QUESTION NO. 794 LEGISLATIVE REFERENDUM NO. 371,FOR THE PROPOSAL - YES,90218,55,36,683,774
CANADIAN,STATE QUESTION NO. 794 LEGISLATIVE REFERENDUM NO. 371,AGAINST THE PROPOSAL - NO,90218,10,13,145,168
CANADIAN,STATE QUESTION NO. 794 LEGISLATIVE REFERENDUM NO. 371,FOR THE PROPOSAL - YES,90220,115,89,1233,1437
CANADIAN,STATE QUESTION NO. 794 LEGISLATIVE REFERENDUM NO. 371,AGAINST THE PROPOSAL - NO,90220,20,19,334,373
CANADIAN,STATE QUESTION NO. 794 LEGISLATIVE REFERENDUM NO. 371,FOR THE PROPOSAL - YES,90221,49,39,786,874
CANADIAN,STATE QUESTION NO. 794 LEGISLATIVE REFERENDUM NO. 371,AGAINST THE PROPOSAL - NO,90221,30,8,200,238
CANADIAN,STATE QUESTION NO. 794 LEGISLATIVE REFERENDUM NO. 371,FOR THE PROPOSAL - YES,90223,88,42,1046,1176
CANADIAN,STATE QUESTION NO. 794 LEGISLATIVE REFERENDUM NO. 371,AGAINST THE PROPOSAL - NO,90223,25,12,280,317
CANADIAN,STATE QUESTION NO. 794 LEGISLATIVE REFERENDUM NO. 371,FOR THE PROPOSAL - YES,90224,61,39,705,805
CANADIAN,STATE QUESTION NO. 794 LEGISLATIVE REFERENDUM NO. 371,AGAINST THE PROPOSAL - NO,90224,18,19,215,252
CANADIAN,STATE QUESTION NO. 794 LEGISLATIVE REFERENDUM NO. 371,FOR THE PROPOSAL - YES,90225,65,34,660,759
CANADIAN,STATE QUESTION NO. 794 LEGISLATIVE REFERENDUM NO. 371,AGAINST THE PROPOSAL - NO,90225,11,10,165,186
CANADIAN,STATE QUESTION NO. 794 LEGISLATIVE REFERENDUM NO. 371,FOR THE PROPOSAL - YES,90226,20,6,243,269
CANADIAN,STATE QUESTION NO. 794 LEGISLATIVE REFERENDUM NO. 371,AGAINST THE PROPOSAL - NO,90226,5,1,60,66
CANADIAN,STATE QUESTION NO. 794 LEGISLATIVE REFERENDUM NO. 371,FOR THE PROPOSAL - YES,90227,149,110,1110,1369
CANADIAN,STATE QUESTION NO. 794 LEGISLATIVE REFERENDUM NO. 371,AGAINST THE PROPOSAL - NO,90227,47,15,338,400
CANADIAN,STATE QUESTION NO. 794 LEGISLATIVE REFERENDUM NO. 371,FOR THE PROPOSAL - YES,90228,26,24,373,423
CANADIAN,STATE QUESTION NO. 794 LEGISLATIVE REFERENDUM NO. 371,AGAINST THE PROPOSAL - NO,90228,4,7,116,127
CANADIAN,STATE QUESTION NO. 794 LEGISLATIVE REFERENDUM NO. 371,FOR THE PROPOSAL - YES,90300,74,39,758,871
CANADIAN,STATE QUESTION NO. 794 LEGISLATIVE REFERENDUM NO. 371,AGAINST THE PROPOSAL - NO,90300,11,6,186,203
CANADIAN,STATE QUESTION NO. 794 LEGISLATIVE REFERENDUM NO. 371,FOR THE PROPOSAL - YES,90301,106,59,1249,1414
CANADIAN,STATE QUESTION NO. 794 LEGISLATIVE REFERENDUM NO. 371,AGAINST THE PROPOSAL - NO,90301,20,6,292,318
CANADIAN,STATE QUESTION NO. 794 LEGISLATIVE REFERENDUM NO. 371,FOR THE PROPOSAL - YES,90302,80,29,949,1058
CANADIAN,STATE QUESTION NO. 794 LEGISLATIVE REFERENDUM NO. 371,AGAINST THE PROPOSAL - NO,90302,21,4,213,238
CANADIAN,STATE QUESTION NO. 794 LEGISLATIVE REFERENDUM NO. 371,FOR THE PROPOSAL - YES,90303,191,102,1439,1732
CANADIAN,STATE QUESTION NO. 794 LEGISLATIVE REFERENDUM NO. 371,AGAINST THE PROPOSAL - NO,90303,40,25,359,424
CANADIAN,STATE QUESTION NO. 794 LEGISLATIVE REFERENDUM NO. 371,FOR THE PROPOSAL - YES,90304,38,23,803,864
CANADIAN,STATE QUESTION NO. 794 LEGISLATIVE REFERENDUM NO. 371,AGAINST THE PROPOSAL - NO,90304,11,8,168,187
CANADIAN,STATE QUESTION NO. 794 LEGISLATIVE REFERENDUM NO. 371,FOR THE PROPOSAL - YES,90306,120,64,1335,1519
CANADIAN,STATE QUESTION NO. 794 LEGISLATIVE REFERENDUM NO. 371,AGAINST THE PROPOSAL - NO,90306,22,9,326,357
CANADIAN,STATE QUESTION NO. 794 LEGISLATIVE REFERENDUM NO. 371,FOR THE PROPOSAL - YES,90308,24,15,289,328
CANADIAN,STATE QUESTION NO. 794 LEGISLATIVE REFERENDUM NO. 371,AGAINST THE PROPOSAL - NO,90308,3,4,78,85
CANADIAN,STATE QUESTION NO. 794 LEGISLATIVE REFERENDUM NO. 371,FOR THE PROPOSAL - YES,90309,6,4,74,84
CANADIAN,STATE QUESTION NO. 794 LEGISLATIVE REFERENDUM NO. 371,AGAINST THE PROPOSAL - NO,90309,1,0,15,16
CANADIAN,STATE QUESTION NO. 794 LEGISLATIVE REFERENDUM NO. 371,FOR THE PROPOSAL - YES,90398,0,0,0,0
CANADIAN,STATE QUESTION NO. 794 LEGISLATIVE REFERENDUM NO. 371,AGAINST THE PROPOSAL - NO,90398,0,0,0,0
CANADIAN,STATE QUESTION NO. 794 LEGISLATIVE REFERENDUM NO. 371,FOR THE PROPOSAL - YES,90399,0,0,0,0
CANADIAN,STATE QUESTION NO. 794 LEGISLATIVE REFERENDUM NO. 371,AGAINST THE PROPOSAL - NO,90399,0,0,0,0
CANADIAN,STATE QUESTION NO. 794 LEGISLATIVE REFERENDUM NO. 371,FOR THE PROPOSAL - YES,90400,23,31,438,492
CANADIAN,STATE QUESTION NO. 794 LEGISLATIVE REFERENDUM NO. 371,AGAINST THE PROPOSAL - NO,90400,7,5,115,127
CANADIAN,STATE QUESTION NO. 794 LEGISLATIVE REFERENDUM NO. 371,FOR THE PROPOSAL - YES,90403,10,12,208,230
CANADIAN,STATE QUESTION NO. 794 LEGISLATIVE REFERENDUM NO. 371,AGAINST THE PROPOSAL - NO,90403,2,2,31,35
CANADIAN,STATE QUESTION NO. 794 LEGISLATIVE REFERENDUM NO. 371,FOR THE PROPOSAL - YES,90404,5,15,129,149
CANADIAN,STATE QUESTION NO. 794 LEGISLATIVE REFERENDUM NO. 371,AGAINST THE PROPOSAL - NO,90404,1,1,22,24
CANADIAN,STATE QUESTION NO. 794 LEGISLATIVE REFERENDUM NO. 371,FOR THE PROPOSAL - YES,90406,4,6,104,114
CANADIAN,STATE QUESTION NO. 794 LEGISLATIVE REFERENDUM NO. 371,AGAINST THE PROPOSAL - NO,90406,0,3,25,28
CANADIAN,STATE QUESTION NO. 794 LEGISLATIVE REFERENDUM NO. 371,FOR THE PROPOSAL - YES,90408,3,10,172,185
CANADIAN,STATE QUESTION NO. 794 LEGISLATIVE REFERENDUM NO. 371,AGAINST THE PROPOSAL - NO,90408,0,3,62,65
CANADIAN,STATE QUESTION NO. 794 LEGISLATIVE REFERENDUM NO. 371,FOR THE PROPOSAL - YES,90409,2,0,25,27
CANADIAN,STATE QUESTION NO. 794 LEGISLATIVE REFERENDUM NO. 371,AGAINST THE PROPOSAL - NO,90409,1,0,8,9
CANADIAN,STATE QUESTION NO. 794 LEGISLATIVE REFERENDUM NO. 371,FOR THE PROPOSAL - YES,90502,3,6,140,149
CANADIAN,STATE QUESTION NO. 794 LEGISLATIVE REFERENDUM NO. 371,AGAINST THE PROPOSAL - NO,90502,1,1,30,32
CANADIAN,STATE QUESTION NO. 794 LEGISLATIVE REFERENDUM NO. 371,FOR THE PROPOSAL - YES,90503,7,6,241,254
CANADIAN,STATE QUESTION NO. 794 LEGISLATIVE REFERENDUM NO. 371,AGAINST THE PROPOSAL - NO,90503,10,2,52,64
CANADIAN,STATE QUESTION NO. 794 LEGISLATIVE REFERENDUM NO. 371,FOR THE PROPOSAL - YES,90504,71,38,1339,1448
CANADIAN,STATE QUESTION NO. 794 LEGISLATIVE REFERENDUM NO. 371,AGAINST THE PROPOSAL - NO,90504,18,6,278,302
CANADIAN,STATE QUESTION NO. 794 LEGISLATIVE REFERENDUM NO. 371,FOR THE PROPOSAL - YES,90506,196,66,1654,1916
CANADIAN,STATE QUESTION NO. 794 LEGISLATIVE REFERENDUM NO. 371,AGAINST THE PROPOSAL - NO,90506,48,20,451,519
CARTER,STATE QUESTION NO. 794 LEGISLATIVE REFERENDUM NO. 371,FOR THE PROPOSAL - YES,100001,15,58,359,432
CARTER,STATE QUESTION NO. 794 LEGISLATIVE REFERENDUM NO. 371,AGAINST THE PROPOSAL - NO,100001,4,18,78,100
CARTER,STATE QUESTION NO. 794 LEGISLATIVE REFERENDUM NO. 371,FOR THE PROPOSAL - YES,100002,22,80,430,532
CARTER,STATE QUESTION NO. 794 LEGISLATIVE REFERENDUM NO. 371,AGAINST THE PROPOSAL - NO,100002,10,17,119,146
CARTER,STATE QUESTION NO. 794 LEGISLATIVE REFERENDUM NO. 371,FOR THE PROPOSAL - YES,100007,13,46,265,324
CARTER,STATE QUESTION NO. 794 LEGISLATIVE REFERENDUM NO. 371,AGAINST THE PROPOSAL - NO,100007,2,7,69,78
CARTER,STATE QUESTION NO. 794 LEGISLATIVE REFERENDUM NO. 371,FOR THE PROPOSAL - YES,100011,9,56,231,296
CARTER,STATE QUESTION NO. 794 LEGISLATIVE REFERENDUM NO. 371,AGAINST THE PROPOSAL - NO,100011,3,14,53,70
CARTER,STATE QUESTION NO. 794 LEGISLATIVE REFERENDUM NO. 371,FOR THE PROPOSAL - YES,100014,9,44,222,275
CARTER,STATE QUESTION NO. 794 LEGISLATIVE REFERENDUM NO. 371,AGAINST THE PROPOSAL - NO,100014,2,19,57,78
CARTER,STATE QUESTION NO. 794 LEGISLATIVE REFERENDUM NO. 371,FOR THE PROPOSAL - YES,100015,20,108,438,566
CARTER,STATE QUESTION NO. 794 LEGISLATIVE REFERENDUM NO. 371,AGAINST THE PROPOSAL - NO,100015,8,22,107,137
CARTER,STATE QUESTION NO. 794 LEGISLATIVE REFERENDUM NO. 371,FOR THE PROPOSAL - YES,100017,10,66,373,449
CARTER,STATE QUESTION NO. 794 LEGISLATIVE REFERENDUM NO. 371,AGAINST THE PROPOSAL - NO,100017,3,20,99,122
CARTER,STATE QUESTION NO. 794 LEGISLATIVE REFERENDUM NO. 371,FOR THE PROPOSAL - YES,100019,59,285,908,1252
CARTER,STATE QUESTION NO. 794 LEGISLATIVE REFERENDUM NO. 371,AGAINST THE PROPOSAL - NO,100019,16,78,239,333
CARTER,STATE QUESTION NO. 794 LEGISLATIVE REFERENDUM NO. 371,FOR THE PROPOSAL - YES,100020,10,58,435,503
CARTER,STATE QUESTION NO. 794 LEGISLATIVE REFERENDUM NO. 371,AGAINST THE PROPOSAL - NO,100020,5,6,125,136
CARTER,STATE QUESTION NO. 794 LEGISLATIVE REFERENDUM NO. 371,FOR THE PROPOSAL - YES,100024,15,116,533,664
CARTER,STATE QUESTION NO. 794 LEGISLATIVE REFERENDUM NO. 371,AGAINST THE PROPOSAL - NO,100024,10,41,156,207
CARTER,STATE QUESTION NO. 794 LEGISLATIVE REFERENDUM NO. 371,FOR THE PROPOSAL - YES,100025,4,33,180,217
CARTER,STATE QUESTION NO. 794 LEGISLATIVE REFERENDUM NO. 371,AGAINST THE PROPOSAL - NO,100025,3,5,60,68
CARTER,STATE QUESTION NO. 794 LEGISLATIVE REFERENDUM NO. 371,FOR THE PROPOSAL - YES,100026,6,15,140,161
CARTER,STATE QUESTION NO. 794 LEGISLATIVE REFERENDUM NO. 371,AGAINST THE PROPOSAL - NO,100026,0,5,40,45
CARTER,STATE QUESTION NO. 794 LEGISLATIVE REFERENDUM NO. 371,FOR THE PROPOSAL - YES,100030,5,9,156,170
CARTER,STATE QUESTION NO. 794 LEGISLATIVE REFERENDUM NO. 371,AGAINST THE PROPOSAL - NO,100030,0,8,50,58
CARTER,STATE QUESTION NO. 794 LEGISLATIVE REFERENDUM NO. 371,FOR THE PROPOSAL - YES,100031,30,109,779,918
CARTER,STATE QUESTION NO. 794 LEGISLATIVE REFERENDUM NO. 371,AGAINST THE PROPOSAL - NO,100031,5,31,200,236
CARTER,STATE QUESTION NO. 794 LEGISLATIVE REFERENDUM NO. 371,FOR THE PROPOSAL - YES,100032,2,18,151,171
CARTER,STATE QUESTION NO. 794 LEGISLATIVE REFERENDUM NO. 371,AGAINST THE PROPOSAL - NO,100032,1,7,42,50
CARTER,STATE QUESTION NO. 794 LEGISLATIVE REFERENDUM NO. 371,FOR THE PROPOSAL - YES,100033,11,18,271,300
CARTER,STATE QUESTION NO. 794 LEGISLATIVE REFERENDUM NO. 371,AGAINST THE PROPOSAL - NO,100033,3,7,80,90
CARTER,STATE QUESTION NO. 794 LEGISLATIVE REFERENDUM NO. 371,FOR THE PROPOSAL - YES,100034,6,32,405,443
CARTER,STATE QUESTION NO. 794 LEGISLATIVE REFERENDUM NO. 371,AGAINST THE PROPOSAL - NO,100034,4,12,118,134
CARTER,STATE QUESTION NO. 794 LEGISLATIVE REFERENDUM NO. 371,FOR THE PROPOSAL - YES,100039,2,17,175,194
CARTER,STATE QUESTION NO. 794 LEGISLATIVE REFERENDUM NO. 371,AGAINST THE PROPOSAL - NO,100039,1,2,67,70
CARTER,STATE QUESTION NO. 794 LEGISLATIVE REFERENDUM NO. 371,FOR THE PROPOSAL - YES,100041,10,14,498,522
CARTER,STATE QUESTION NO. 794 LEGISLATIVE REFERENDUM NO. 371,AGAINST THE PROPOSAL - NO,100041,8,4,127,139
CARTER,STATE QUESTION NO. 794 LEGISLATIVE REFERENDUM NO. 371,FOR THE PROPOSAL - YES,100051,2,9,175,186
CARTER,STATE QUESTION NO. 794 LEGISLATIVE REFERENDUM NO. 371,AGAINST THE PROPOSAL - NO,100051,1,1,50,52
CARTER,STATE QUESTION NO. 794 LEGISLATIVE REFERENDUM NO. 371,FOR THE PROPOSAL - YES,100052,7,11,257,275
CARTER,STATE QUESTION NO. 794 LEGISLATIVE REFERENDUM NO. 371,AGAINST THE PROPOSAL - NO,100052,0,1,81,82
CARTER,STATE QUESTION NO. 794 LEGISLATIVE REFERENDUM NO. 371,FOR THE PROPOSAL - YES,100061,3,35,270,308
CARTER,STATE QUESTION NO. 794 LEGISLATIVE REFERENDUM NO. 371,AGAINST THE PROPOSAL - NO,100061,3,12,83,98
CARTER,STATE QUESTION NO. 794 LEGISLATIVE REFERENDUM NO. 371,FOR THE PROPOSAL - YES,100062,13,61,443,517
CARTER,STATE QUESTION NO. 794 LEGISLATIVE REFERENDUM NO. 371,AGAINST THE PROPOSAL - NO,100062,2,15,124,141
CARTER,STATE QUESTION NO. 794 LEGISLATIVE REFERENDUM NO. 371,FOR THE PROPOSAL - YES,100063,11,70,529,610
CARTER,STATE QUESTION NO. 794 LEGISLATIVE REFERENDUM NO. 371,AGAINST THE PROPOSAL - NO,100063,1,13,160,174
CARTER,STATE QUESTION NO. 794 LEGISLATIVE REFERENDUM NO. 371,FOR THE PROPOSAL - YES,100071,6,10,392,408
CARTER,STATE QUESTION NO. 794 LEGISLATIVE REFERENDUM NO. 371,AGAINST THE PROPOSAL - NO,100071,3,2,136,141
CHEROKEE,STATE QUESTION NO. 794 LEGISLATIVE REFERENDUM NO. 371,FOR THE PROPOSAL - YES,110001,17,131,516,664
CHEROKEE,STATE QUESTION NO. 794 LEGISLATIVE REFERENDUM NO. 371,AGAINST THE PROPOSAL - NO,110001,8,51,167,226
CHEROKEE,STATE QUESTION NO. 794 LEGISLATIVE REFERENDUM NO. 371,FOR THE PROPOSAL - YES,110002,65,355,671,1091
CHEROKEE,STATE QUESTION NO. 794 LEGISLATIVE REFERENDUM NO. 371,AGAINST THE PROPOSAL - NO,110002,19,108,195,322
CHEROKEE,STATE QUESTION NO. 794 LEGISLATIVE REFERENDUM NO. 371,FOR THE PROPOSAL - YES,110003,51,317,560,928
CHEROKEE,STATE QUESTION NO. 794 LEGISLATIVE REFERENDUM NO. 371,AGAINST THE PROPOSAL - NO,110003,6,94,136,236
CHEROKEE,STATE QUESTION NO. 794 LEGISLATIVE REFERENDUM NO. 371,FOR THE PROPOSAL - YES,110004,32,329,547,908
CHEROKEE,STATE QUESTION NO. 794 LEGISLATIVE REFERENDUM NO. 371,AGAINST THE PROPOSAL - NO,110004,8,70,196,274
CHEROKEE,STATE QUESTION NO. 794 LEGISLATIVE REFERENDUM NO. 371,FOR THE PROPOSAL - YES,110005,6,28,136,170
CHEROKEE,STATE QUESTION NO. 794 LEGISLATIVE REFERENDUM NO. 371,AGAINST THE PROPOSAL - NO,110005,4,8,28,40
CHEROKEE,STATE QUESTION NO. 794 LEGISLATIVE REFERENDUM NO. 371,FOR THE PROPOSAL - YES,110006,11,71,247,329
CHEROKEE,STATE QUESTION NO. 794 LEGISLATIVE REFERENDUM NO. 371,AGAINST THE PROPOSAL - NO,110006,6,17,56,79
CHEROKEE,STATE QUESTION NO. 794 LEGISLATIVE REFERENDUM NO. 371,FOR THE PROPOSAL - YES,110007,2,17,48,67
CHEROKEE,STATE QUESTION NO. 794 LEGISLATIVE REFERENDUM NO. 371,AGAINST THE PROPOSAL - NO,110007,3,7,21,31
CHEROKEE,STATE QUESTION NO. 794 LEGISLATIVE REFERENDUM NO. 371,FOR THE PROPOSAL - YES,110008,10,46,193,249
CHEROKEE,STATE QUESTION NO. 794 LEGISLATIVE REFERENDUM NO. 371,AGAINST THE PROPOSAL - NO,110008,0,14,56,70
CHEROKEE,STATE QUESTION NO. 794 LEGISLATIVE REFERENDUM NO. 371,FOR THE PROPOSAL - YES,110009,27,44,461,532
CHEROKEE,STATE QUESTION NO. 794 LEGISLATIVE REFERENDUM NO. 371,AGAINST THE PROPOSAL - NO,110009,8,13,77,98
CHEROKEE,STATE QUESTION NO. 794 LEGISLATIVE REFERENDUM NO. 371,FOR THE PROPOSAL - YES,110010,38,120,688,846
CHEROKEE,STATE QUESTION NO. 794 LEGISLATIVE REFERENDUM NO. 371,AGAINST THE PROPOSAL - NO,110010,9,36,167,212
CHEROKEE,STATE QUESTION NO. 794 LEGISLATIVE REFERENDUM NO. 371,FOR THE PROPOSAL - YES,110011,9,46,186,241
CHEROKEE,STATE QUESTION NO. 794 LEGISLATIVE REFERENDUM NO. 371,AGAINST THE PROPOSAL - NO,110011,3,11,49,63
CHEROKEE,STATE QUESTION NO. 794 LEGISLATIVE REFERENDUM NO. 371,FOR THE PROPOSAL - YES,110012,16,127,481,624
CHEROKEE,STATE QUESTION NO. 794 LEGISLATIVE REFERENDUM NO. 371,AGAINST THE PROPOSAL - NO,110012,3,41,128,172
CHEROKEE,STATE QUESTION NO. 794 LEGISLATIVE REFERENDUM NO. 371,FOR THE PROPOSAL - YES,110013,11,63,298,372
CHEROKEE,STATE QUESTION NO. 794 LEGISLATIVE REFERENDUM NO. 371,AGAINST THE PROPOSAL - NO,110013,4,20,77,101
CHEROKEE,STATE QUESTION NO. 794 LEGISLATIVE REFERENDUM NO. 371,FOR THE PROPOSAL - YES,110014,23,39,473,535
CHEROKEE,STATE QUESTION NO. 794 LEGISLATIVE REFERENDUM NO. 371,AGAINST THE PROPOSAL - NO,110014,5,12,127,144
CHEROKEE,STATE QUESTION NO. 794 LEGISLATIVE REFERENDUM NO. 371,FOR THE PROPOSAL - YES,110015,24,50,571,645
CHEROKEE,STATE QUESTION NO. 794 LEGISLATIVE REFERENDUM NO. 371,AGAINST THE PROPOSAL - NO,110015,8,13,144,165
CHEROKEE,STATE QUESTION NO. 794 LEGISLATIVE REFERENDUM NO. 371,FOR THE PROPOSAL - YES,110016,6,18,204,228
CHEROKEE,STATE QUESTION NO. 794 LEGISLATIVE REFERENDUM NO. 371,AGAINST THE PROPOSAL - NO,110016,0,6,41,47
CHEROKEE,STATE QUESTION NO. 794 LEGISLATIVE REFERENDUM NO. 371,FOR THE PROPOSAL - YES,110017,5,27,160,192
CHEROKEE,STATE QUESTION NO. 794 LEGISLATIVE REFERENDUM NO. 371,AGAINST THE PROPOSAL - NO,110017,1,7,43,51
CHEROKEE,STATE QUESTION NO. 794 LEGISLATIVE REFERENDUM NO. 371,FOR THE PROPOSAL - YES,110018,3,18,143,164
CHEROKEE,STATE QUESTION NO. 794 LEGISLATIVE REFERENDUM NO. 371,AGAINST THE PROPOSAL - NO,110018,5,5,29,39
CHEROKEE,STATE QUESTION NO. 794 LEGISLATIVE REFERENDUM NO. 371,FOR THE PROPOSAL - YES,110019,16,61,319,396
CHEROKEE,STATE QUESTION NO. 794 LEGISLATIVE REFERENDUM NO. 371,AGAINST THE PROPOSAL - NO,110019,2,23,94,119
CHEROKEE,STATE QUESTION NO. 794 LEGISLATIVE REFERENDUM NO. 371,FOR THE PROPOSAL - YES,110020,29,157,399,585
CHEROKEE,STATE QUESTION NO. 794 LEGISLATIVE REFERENDUM NO. 371,AGAINST THE PROPOSAL - NO,110020,11,46,145,202
CHEROKEE,STATE QUESTION NO. 794 LEGISLATIVE REFERENDUM NO. 371,FOR THE PROPOSAL - YES,110021,10,18,208,236
CHEROKEE,STATE QUESTION NO. 794 LEGISLATIVE REFERENDUM NO. 371,AGAINST THE PROPOSAL - NO,110021,5,6,64,75
CHEROKEE,STATE QUESTION NO. 794 LEGISLATIVE REFERENDUM NO. 371,FOR THE PROPOSAL - YES,110022,3,19,117,139
CHEROKEE,STATE QUESTION NO. 794 LEGISLATIVE REFERENDUM NO. 371,AGAINST THE PROPOSAL - NO,110022,1,5,37,43
CHEROKEE,STATE QUESTION NO. 794 LEGISLATIVE REFERENDUM NO. 371,FOR THE PROPOSAL - YES,110023,2,35,120,157
CHEROKEE,STATE QUESTION NO. 794 LEGISLATIVE REFERENDUM NO. 371,AGAINST THE PROPOSAL - NO,110023,3,20,32,55
CHEROKEE,STATE QUESTION NO. 794 LEGISLATIVE REFERENDUM NO. 371,FOR THE PROPOSAL - YES,110025,10,93,285,388
CHEROKEE,STATE QUESTION NO. 794 LEGISLATIVE REFERENDUM NO. 371,AGAINST THE PROPOSAL - NO,110025,1,32,79,112
CHOCTAW,STATE QUESTION NO. 794 LEGISLATIVE REFERENDUM NO. 371,FOR THE PROPOSAL - YES,120101,5,13,338,356
CHOCTAW,STATE QUESTION NO. 794 LEGISLATIVE REFERENDUM NO. 371,AGAINST THE PROPOSAL - NO,120101,0,8,76,84
CHOCTAW,STATE QUESTION NO. 794 LEGISLATIVE REFERENDUM NO. 371,FOR THE PROPOSAL - YES,120104,8,40,297,345
CHOCTAW,STATE QUESTION NO. 794 LEGISLATIVE REFERENDUM NO. 371,AGAINST THE PROPOSAL - NO,120104,0,5,75,80
CHOCTAW,STATE QUESTION NO. 794 LEGISLATIVE REFERENDUM NO. 371,FOR THE PROPOSAL - YES,120105,0,15,84,99
CHOCTAW,STATE QUESTION NO. 794 LEGISLATIVE REFERENDUM NO. 371,AGAINST THE PROPOSAL - NO,120105,0,3,23,26
CHOCTAW,STATE QUESTION NO. 794 LEGISLATIVE REFERENDUM NO. 371,FOR THE PROPOSAL - YES,120106,5,13,150,168
CHOCTAW,STATE QUESTION NO. 794 LEGISLATIVE REFERENDUM NO. 371,AGAINST THE PROPOSAL - NO,120106,1,3,36,40
CHOCTAW,STATE QUESTION NO. 794 LEGISLATIVE REFERENDUM NO. 371,FOR THE PROPOSAL - YES,120207,0,1,61,62
CHOCTAW,STATE QUESTION NO. 794 LEGISLATIVE REFERENDUM NO. 371,AGAINST THE PROPOSAL - NO,120207,0,0,18,18
CHOCTAW,STATE QUESTION NO. 794 LEGISLATIVE REFERENDUM NO. 371,FOR THE PROPOSAL - YES,120208,5,58,189,252
CHOCTAW,STATE QUESTION NO. 794 LEGISLATIVE REFERENDUM NO. 371,AGAINST THE PROPOSAL - NO,120208,1,16,38,55
CHOCTAW,STATE QUESTION NO. 794 LEGISLATIVE REFERENDUM NO. 371,FOR THE PROPOSAL - YES,120209,0,5,75,80
CHOCTAW,STATE QUESTION NO. 794 LEGISLATIVE REFERENDUM NO. 371,AGAINST THE PROPOSAL - NO,120209,3,0,22,25
CHOCTAW,STATE QUESTION NO. 794 LEGISLATIVE REFERENDUM NO. 371,FOR THE PROPOSAL - YES,120210,17,59,245,321
CHOCTAW,STATE QUESTION NO. 794 LEGISLATIVE REFERENDUM NO. 371,AGAINST THE PROPOSAL - NO,120210,4,14,51,69
CHOCTAW,STATE QUESTION NO. 794 LEGISLATIVE REFERENDUM NO. 371,FOR THE PROPOSAL - YES,120211,3,6,38,47
CHOCTAW,STATE QUESTION NO. 794 LEGISLATIVE REFERENDUM NO. 371,AGAINST THE PROPOSAL - NO,120211,0,3,17,20
CHOCTAW,STATE QUESTION NO. 794 LEGISLATIVE REFERENDUM NO. 371,FOR THE PROPOSAL - YES,120214,1,28,108,137
CHOCTAW,STATE QUESTION NO. 794 LEGISLATIVE REFERENDUM NO. 371,AGAINST THE PROPOSAL - NO,120214,4,4,47,55
CHOCTAW,STATE QUESTION NO. 794 LEGISLATIVE REFERENDUM NO. 371,FOR THE PROPOSAL - YES,120215,4,24,75,103
CHOCTAW,STATE QUESTION NO. 794 LEGISLATIVE REFERENDUM NO. 371,AGAINST THE PROPOSAL - NO,120215,2,14,19,35
CHOCTAW,STATE QUESTION NO. 794 LEGISLATIVE REFERENDUM NO. 371,FOR THE PROPOSAL - YES,120316,13,63,224,300
CHOCTAW,STATE QUESTION NO. 794 LEGISLATIVE REFERENDUM NO. 371,AGAINST THE PROPOSAL - NO,120316,1,21,61,83
CHOCTAW,STATE QUESTION NO. 794 LEGISLATIVE REFERENDUM NO. 371,FOR THE PROPOSAL - YES,120318,3,42,156,201
CHOCTAW,STATE QUESTION NO. 794 LEGISLATIVE REFERENDUM NO. 371,AGAINST THE PROPOSAL - NO,120318,0,8,51,59
CHOCTAW,STATE QUESTION NO. 794 LEGISLATIVE REFERENDUM NO. 371,FOR THE PROPOSAL - YES,120319,13,31,126,170
CHOCTAW,STATE QUESTION NO. 794 LEGISLATIVE REFERENDUM NO. 371,AGAINST THE PROPOSAL - NO,120319,2,2,55,59
CHOCTAW,STATE QUESTION NO. 794 LEGISLATIVE REFERENDUM NO. 371,FOR THE PROPOSAL - YES,120320,0,4,98,102
CHOCTAW,STATE QUESTION NO. 794 LEGISLATIVE REFERENDUM NO. 371,AGAINST THE PROPOSAL - NO,120320,0,5,24,29
CHOCTAW,STATE QUESTION NO. 794 LEGISLATIVE REFERENDUM NO. 371,FOR THE PROPOSAL - YES,120321,11,23,172,206
CHOCTAW,STATE QUESTION NO. 794 LEGISLATIVE REFERENDUM NO. 371,AGAINST THE PROPOSAL - NO,120321,3,4,62,69
CHOCTAW,STATE QUESTION NO. 794 LEGISLATIVE REFERENDUM NO. 371,FOR THE PROPOSAL - YES,120322,3,1,82,86
CHOCTAW,STATE QUESTION NO. 794 LEGISLATIVE REFERENDUM NO. 371,AGAINST THE PROPOSAL - NO,120322,1,3,39,43
CIMARRON,STATE QUESTION NO. 794 LEGISLATIVE REFERENDUM NO. 371,FOR THE PROPOSAL - YES,130002,12,15,62,89
CIMARRON,STATE QUESTION NO. 794 LEGISLATIVE REFERENDUM NO. 371,AGAINST THE PROPOSAL - NO,130002,2,8,20,30
CIMARRON,STATE QUESTION NO. 794 LEGISLATIVE REFERENDUM NO. 371,FOR THE PROPOSAL - YES,130003,2,14,73,89
CIMARRON,STATE QUESTION NO. 794 LEGISLATIVE REFERENDUM NO. 371,AGAINST THE PROPOSAL - NO,130003,2,7,32,41
CIMARRON,STATE QUESTION NO. 794 LEGISLATIVE REFERENDUM NO. 371,FOR THE PROPOSAL - YES,130004,3,16,84,103
CIMARRON,STATE QUESTION NO. 794 LEGISLATIVE REFERENDUM NO. 371,AGAINST THE PROPOSAL - NO,130004,1,11,37,49
CIMARRON,STATE QUESTION NO. 794 LEGISLATIVE REFERENDUM NO. 371,FOR THE PROPOSAL - YES,130005,2,15,63,80
CIMARRON,STATE QUESTION NO. 794 LEGISLATIVE REFERENDUM NO. 371,AGAINST THE PROPOSAL - NO,130005,0,9,31,40
CIMARRON,STATE QUESTION NO. 794 LEGISLATIVE REFERENDUM NO. 371,FOR THE PROPOSAL - YES,130006,9,36,94,139
CIMARRON,STATE QUESTION NO. 794 LEGISLATIVE REFERENDUM NO. 371,AGAINST THE PROPOSAL - NO,130006,2,16,43,61
CIMARRON,STATE QUESTION NO. 794 LEGISLATIVE REFERENDUM NO. 371,FOR THE PROPOSAL - YES,130007,5,5,21,31
CIMARRON,STATE QUESTION NO. 794 LEGISLATIVE REFERENDUM NO. 371,AGAINST THE PROPOSAL - NO,130007,1,2,12,15
CLEVELAND,STATE QUESTION NO. 794 LEGISLATIVE REFERENDUM NO. 371,FOR THE PROPOSAL - YES,140001,176,284,714,1174
CLEVELAND,STATE QUESTION NO. 794 LEGISLATIVE REFERENDUM NO. 371,AGAINST THE PROPOSAL - NO,140001,48,80,317,445
CLEVELAND,STATE QUESTION NO. 794 LEGISLATIVE REFERENDUM NO. 371,FOR THE PROPOSAL - YES,140002,21,32,295,348
CLEVELAND,STATE QUESTION NO. 794 LEGISLATIVE REFERENDUM NO. 371,AGAINST THE PROPOSAL - NO,140002,5,17,154,176
CLEVELAND,STATE QUESTION NO. 794 LEGISLATIVE REFERENDUM NO. 371,FOR THE PROPOSAL - YES,140003,32,50,431,513
CLEVELAND,STATE QUESTION NO. 794 LEGISLATIVE REFERENDUM NO. 371,AGAINST THE PROPOSAL - NO,140003,5,15,200,220
CLEVELAND,STATE QUESTION NO. 794 LEGISLATIVE REFERENDUM NO. 371,FOR THE PROPOSAL - YES,140004,143,282,902,1327
CLEVELAND,STATE QUESTION NO. 794 LEGISLATIVE REFERENDUM NO. 371,AGAINST THE PROPOSAL - NO,140004,25,52,241,318
CLEVELAND,STATE QUESTION NO. 794 LEGISLATIVE REFERENDUM NO. 371,FOR THE PROPOSAL - YES,140005,179,222,1108,1509
CLEVELAND,STATE QUESTION NO. 794 LEGISLATIVE REFERENDUM NO. 371,AGAINST THE PROPOSAL - NO,140005,37,44,240,321
CLEVELAND,STATE QUESTION NO. 794 LEGISLATIVE REFERENDUM NO. 371,FOR THE PROPOSAL - YES,140006,56,48,348,452
CLEVELAND,STATE QUESTION NO. 794 LEGISLATIVE REFERENDUM NO. 371,AGAINST THE PROPOSAL - NO,140006,25,54,300,379
CLEVELAND,STATE QUESTION NO. 794 LEGISLATIVE REFERENDUM NO. 371,FOR THE PROPOSAL - YES,140007,90,166,863,1119
CLEVELAND,STATE QUESTION NO. 794 LEGISLATIVE REFERENDUM NO. 371,AGAINST THE PROPOSAL - NO,140007,21,40,267,328
CLEVELAND,STATE QUESTION NO. 794 LEGISLATIVE REFERENDUM NO. 371,FOR THE PROPOSAL - YES,140008,40,44,359,443
CLEVELAND,STATE QUESTION NO. 794 LEGISLATIVE REFERENDUM NO. 371,AGAINST THE PROPOSAL - NO,140008,13,23,266,302
CLEVELAND,STATE QUESTION NO. 794 LEGISLATIVE REFERENDUM NO. 371,FOR THE PROPOSAL - YES,140009,102,220,898,1220
CLEVELAND,STATE QUESTION NO. 794 LEGISLATIVE REFERENDUM NO. 371,AGAINST THE PROPOSAL - NO,140009,20,44,257,321
CLEVELAND,STATE QUESTION NO. 794 LEGISLATIVE REFERENDUM NO. 371,FOR THE PROPOSAL - YES,140010,49,55,524,628
CLEVELAND,STATE QUESTION NO. 794 LEGISLATIVE REFERENDUM NO. 371,AGAINST THE PROPOSAL - NO,140010,6,5,130,141
CLEVELAND,STATE QUESTION NO. 794 LEGISLATIVE REFERENDUM NO. 371,FOR THE PROPOSAL - YES,140011,29,47,483,559
CLEVELAND,STATE QUESTION NO. 794 LEGISLATIVE REFERENDUM NO. 371,AGAINST THE PROPOSAL - NO,140011,24,36,310,370
CLEVELAND,STATE QUESTION NO. 794 LEGISLATIVE REFERENDUM NO. 371,FOR THE PROPOSAL - YES,140012,93,156,782,1031
CLEVELAND,STATE QUESTION NO. 794 LEGISLATIVE REFERENDUM NO. 371,AGAINST THE PROPOSAL - NO,140012,22,57,236,315
CLEVELAND,STATE QUESTION NO. 794 LEGISLATIVE REFERENDUM NO. 371,FOR THE PROPOSAL - YES,140013,12,16,210,238
CLEVELAND,STATE QUESTION NO. 794 LEGISLATIVE REFERENDUM NO. 371,AGAINST THE PROPOSAL - NO,140013,3,4,92,99
CLEVELAND,STATE QUESTION NO. 794 LEGISLATIVE REFERENDUM NO. 371,FOR THE PROPOSAL - YES,140014,38,47,428,513
CLEVELAND,STATE QUESTION NO. 794 LEGISLATIVE REFERENDUM NO. 371,AGAINST THE PROPOSAL - NO,140014,21,15,237,273
CLEVELAND,STATE QUESTION NO. 794 LEGISLATIVE REFERENDUM NO. 371,FOR THE PROPOSAL - YES,140015,38,73,506,617
CLEVELAND,STATE QUESTION NO. 794 LEGISLATIVE REFERENDUM NO. 371,AGAINST THE PROPOSAL - NO,140015,14,43,306,363
CLEVELAND,STATE QUESTION NO. 794 LEGISLATIVE REFERENDUM NO. 371,FOR THE PROPOSAL - YES,140016,73,51,718,842
CLEVELAND,STATE QUESTION NO. 794 LEGISLATIVE REFERENDUM NO. 371,AGAINST THE PROPOSAL - NO,140016,15,12,192,219
CLEVELAND,STATE QUESTION NO. 794 LEGISLATIVE REFERENDUM NO. 371,FOR THE PROPOSAL - YES,140017,27,19,304,350
CLEVELAND,STATE QUESTION NO. 794 LEGISLATIVE REFERENDUM NO. 371,AGAINST THE PROPOSAL - NO,140017,5,3,57,65
CLEVELAND,STATE QUESTION NO. 794 LEGISLATIVE REFERENDUM NO. 371,FOR THE PROPOSAL - YES,140018,40,68,558,666
CLEVELAND,STATE QUESTION NO. 794 LEGISLATIVE REFERENDUM NO. 371,AGAINST THE PROPOSAL - NO,140018,9,26,282,317
CLEVELAND,STATE QUESTION NO. 794 LEGISLATIVE REFERENDUM NO. 371,FOR THE PROPOSAL - YES,140019,88,170,862,1120
CLEVELAND,STATE QUESTION NO. 794 LEGISLATIVE REFERENDUM NO. 371,AGAINST THE PROPOSAL - NO,140019,27,88,390,505
CLEVELAND,STATE QUESTION NO. 794 LEGISLATIVE REFERENDUM NO. 371,FOR THE PROPOSAL - YES,140020,150,447,902,1499
CLEVELAND,STATE QUESTION NO. 794 LEGISLATIVE REFERENDUM NO. 371,AGAINST THE PROPOSAL - NO,140020,47,116,281,444
CLEVELAND,STATE QUESTION NO. 794 LEGISLATIVE REFERENDUM NO. 371,FOR THE PROPOSAL - YES,140021,42,34,495,571
CLEVELAND,STATE QUESTION NO. 794 LEGISLATIVE REFERENDUM NO. 371,AGAINST THE PROPOSAL - NO,140021,7,13,122,142
CLEVELAND,STATE QUESTION NO. 794 LEGISLATIVE REFERENDUM NO. 371,FOR THE PROPOSAL - YES,140022,134,127,1025,1286
CLEVELAND,STATE QUESTION NO. 794 LEGISLATIVE REFERENDUM NO. 371,AGAINST THE PROPOSAL - NO,140022,30,26,297,353
CLEVELAND,STATE QUESTION NO. 794 LEGISLATIVE REFERENDUM NO. 371,FOR THE PROPOSAL - YES,140024,268,288,1213,1769
CLEVELAND,STATE QUESTION NO. 794 LEGISLATIVE REFERENDUM NO. 371,AGAINST THE PROPOSAL - NO,140024,71,72,319,462
CLEVELAND,STATE QUESTION NO. 794 LEGISLATIVE REFERENDUM NO. 371,FOR THE PROPOSAL - YES,140025,22,28,499,549
CLEVELAND,STATE QUESTION NO. 794 LEGISLATIVE REFERENDUM NO. 371,AGAINST THE PROPOSAL - NO,140025,7,5,141,153
CLEVELAND,STATE QUESTION NO. 794 LEGISLATIVE REFERENDUM NO. 371,FOR THE PROPOSAL - YES,140026,101,159,765,1025
CLEVELAND,STATE QUESTION NO. 794 LEGISLATIVE REFERENDUM NO. 371,AGAINST THE PROPOSAL - NO,140026,44,69,331,444
CLEVELAND,STATE QUESTION NO. 794 LEGISLATIVE REFERENDUM NO. 371,FOR THE PROPOSAL - YES,140027,206,201,973,1380
CLEVELAND,STATE QUESTION NO. 794 LEGISLATIVE REFERENDUM NO. 371,AGAINST THE PROPOSAL - NO,140027,73,89,380,542
CLEVELAND,STATE QUESTION NO. 794 LEGISLATIVE REFERENDUM NO. 371,FOR THE PROPOSAL - YES,140028,60,106,881,1047
CLEVELAND,STATE QUESTION NO. 794 LEGISLATIVE REFERENDUM NO. 371,AGAINST THE PROPOSAL - NO,140028,19,48,373,440
CLEVELAND,STATE QUESTION NO. 794 LEGISLATIVE REFERENDUM NO. 371,FOR THE PROPOSAL - YES,140029,57,80,860,997
CLEVELAND,STATE QUESTION NO. 794 LEGISLATIVE REFERENDUM NO. 371,AGAINST THE PROPOSAL - NO,140029,16,11,235,262
CLEVELAND,STATE QUESTION NO. 794 LEGISLATIVE REFERENDUM NO. 371,FOR THE PROPOSAL - YES,140030,45,69,453,567
CLEVELAND,STATE QUESTION NO. 794 LEGISLATIVE REFERENDUM NO. 371,AGAINST THE PROPOSAL - NO,140030,16,23,206,245
CLEVELAND,STATE QUESTION NO. 794 LEGISLATIVE REFERENDUM NO. 371,FOR THE PROPOSAL - YES,140032,52,110,810,972
CLEVELAND,STATE QUESTION NO. 794 LEGISLATIVE REFERENDUM NO. 371,AGAINST THE PROPOSAL - NO,140032,17,35,346,398
CLEVELAND,STATE QUESTION NO. 794 LEGISLATIVE REFERENDUM NO. 371,FOR THE PROPOSAL - YES,140034,51,38,989,1078
CLEVELAND,STATE QUESTION NO. 794 LEGISLATIVE REFERENDUM NO. 371,AGAINST THE PROPOSAL - NO,140034,9,5,238,252
CLEVELAND,STATE QUESTION NO. 794 LEGISLATIVE REFERENDUM NO. 371,FOR THE PROPOSAL - YES,140035,51,49,540,640
CLEVELAND,STATE QUESTION NO. 794 LEGISLATIVE REFERENDUM NO. 371,AGAINST THE PROPOSAL - NO,140035,12,19,184,215
CLEVELAND,STATE QUESTION NO. 794 LEGISLATIVE REFERENDUM NO. 371,FOR THE PROPOSAL - YES,140036,56,67,653,776
CLEVELAND,STATE QUESTION NO. 794 LEGISLATIVE REFERENDUM NO. 371,AGAINST THE PROPOSAL - NO,140036,10,17,177,204
CLEVELAND,STATE QUESTION NO. 794 LEGISLATIVE REFERENDUM NO. 371,FOR THE PROPOSAL - YES,140037,45,55,691,791
CLEVELAND,STATE QUESTION NO. 794 LEGISLATIVE REFERENDUM NO. 371,AGAINST THE PROPOSAL - NO,140037,8,23,169,200
CLEVELAND,STATE QUESTION NO. 794 LEGISLATIVE REFERENDUM NO. 371,FOR THE PROPOSAL - YES,140038,39,25,637,701
CLEVELAND,STATE QUESTION NO. 794 LEGISLATIVE REFERENDUM NO. 371,AGAINST THE PROPOSAL - NO,140038,6,9,160,175
CLEVELAND,STATE QUESTION NO. 794 LEGISLATIVE REFERENDUM NO. 371,FOR THE PROPOSAL - YES,140039,85,63,615,763
CLEVELAND,STATE QUESTION NO. 794 LEGISLATIVE REFERENDUM NO. 371,AGAINST THE PROPOSAL - NO,140039,28,23,246,297
CLEVELAND,STATE QUESTION NO. 794 LEGISLATIVE REFERENDUM NO. 371,FOR THE PROPOSAL - YES,140040,70,112,789,971
CLEVELAND,STATE QUESTION NO. 794 LEGISLATIVE REFERENDUM NO. 371,AGAINST THE PROPOSAL - NO,140040,14,20,216,250
CLEVELAND,STATE QUESTION NO. 794 LEGISLATIVE REFERENDUM NO. 371,FOR THE PROPOSAL - YES,140041,15,25,343,383
CLEVELAND,STATE QUESTION NO. 794 LEGISLATIVE REFERENDUM NO. 371,AGAINST THE PROPOSAL - NO,140041,3,5,71,79
CLEVELAND,STATE QUESTION NO. 794 LEGISLATIVE REFERENDUM NO. 371,FOR THE PROPOSAL - YES,140042,42,50,360,452
CLEVELAND,STATE QUESTION NO. 794 LEGISLATIVE REFERENDUM NO. 371,AGAINST THE PROPOSAL - NO,140042,21,22,214,257
CLEVELAND,STATE QUESTION NO. 794 LEGISLATIVE REFERENDUM NO. 371,FOR THE PROPOSAL - YES,140043,97,161,1043,1301
CLEVELAND,STATE QUESTION NO. 794 LEGISLATIVE REFERENDUM NO. 371,AGAINST THE PROPOSAL - NO,140043,27,36,292,355
CLEVELAND,STATE QUESTION NO. 794 LEGISLATIVE REFERENDUM NO. 371,FOR THE PROPOSAL - YES,140044,102,114,973,1189
CLEVELAND,STATE QUESTION NO. 794 LEGISLATIVE REFERENDUM NO. 371,AGAINST THE PROPOSAL - NO,140044,16,25,283,324
CLEVELAND,STATE QUESTION NO. 794 LEGISLATIVE REFERENDUM NO. 371,FOR THE PROPOSAL - YES,140045,21,12,344,377
CLEVELAND,STATE QUESTION NO. 794 LEGISLATIVE REFERENDUM NO. 371,AGAINST THE PROPOSAL - NO,140045,4,7,92,103
CLEVELAND,STATE QUESTION NO. 794 LEGISLATIVE REFERENDUM NO. 371,FOR THE PROPOSAL - YES,140047,41,56,681,778
CLEVELAND,STATE QUESTION NO. 794 LEGISLATIVE REFERENDUM NO. 371,AGAINST THE PROPOSAL - NO,140047,6,7,193,206
CLEVELAND,STATE QUESTION NO. 794 LEGISLATIVE REFERENDUM NO. 371,FOR THE PROPOSAL - YES,140048,44,56,575,675
CLEVELAND,STATE QUESTION NO. 794 LEGISLATIVE REFERENDUM NO. 371,AGAINST THE PROPOSAL - NO,140048,8,14,139,161
CLEVELAND,STATE QUESTION NO. 794 LEGISLATIVE REFERENDUM NO. 371,FOR THE PROPOSAL - YES,140049,16,14,463,493
CLEVELAND,STATE QUESTION NO. 794 LEGISLATIVE REFERENDUM NO. 371,AGAINST THE PROPOSAL - NO,140049,4,7,110,121
CLEVELAND,STATE QUESTION NO. 794 LEGISLATIVE REFERENDUM NO. 371,FOR THE PROPOSAL - YES,140050,71,86,961,1118
CLEVELAND,STATE QUESTION NO. 794 LEGISLATIVE REFERENDUM NO. 371,AGAINST THE PROPOSAL - NO,140050,23,34,250,307
CLEVELAND,STATE QUESTION NO. 794 LEGISLATIVE REFERENDUM NO. 371,FOR THE PROPOSAL - YES,140051,36,27,398,461
CLEVELAND,STATE QUESTION NO. 794 LEGISLATIVE REFERENDUM NO. 371,AGAINST THE PROPOSAL - NO,140051,6,15,152,173
CLEVELAND,STATE QUESTION NO. 794 LEGISLATIVE REFERENDUM NO. 371,FOR THE PROPOSAL - YES,140053,168,225,1219,1612
CLEVELAND,STATE QUESTION NO. 794 LEGISLATIVE REFERENDUM NO. 371,AGAINST THE PROPOSAL - NO,140053,61,62,421,544
CLEVELAND,STATE QUESTION NO. 794 LEGISLATIVE REFERENDUM NO. 371,FOR THE PROPOSAL - YES,140054,22,32,497,551
CLEVELAND,STATE QUESTION NO. 794 LEGISLATIVE REFERENDUM NO. 371,AGAINST THE PROPOSAL - NO,140054,4,6,131,141
CLEVELAND,STATE QUESTION NO. 794 LEGISLATIVE REFERENDUM NO. 371,FOR THE PROPOSAL - YES,140055,95,194,802,1091
CLEVELAND,STATE QUESTION NO. 794 LEGISLATIVE REFERENDUM NO. 371,AGAINST THE PROPOSAL - NO,140055,26,61,329,416
CLEVELAND,STATE QUESTION NO. 794 LEGISLATIVE REFERENDUM NO. 371,FOR THE PROPOSAL - YES,140056,78,127,671,876
CLEVELAND,STATE QUESTION NO. 794 LEGISLATIVE REFERENDUM NO. 371,AGAINST THE PROPOSAL - NO,140056,32,43,295,370
CLEVELAND,STATE QUESTION NO. 794 LEGISLATIVE REFERENDUM NO. 371,FOR THE PROPOSAL - YES,140057,70,88,1038,1196
CLEVELAND,STATE QUESTION NO. 794 LEGISLATIVE REFERENDUM NO. 371,AGAINST THE PROPOSAL - NO,140057,13,20,330,363
CLEVELAND,STATE QUESTION NO. 794 LEGISLATIVE REFERENDUM NO. 371,FOR THE PROPOSAL - YES,140058,70,71,735,876
CLEVELAND,STATE QUESTION NO. 794 LEGISLATIVE REFERENDUM NO. 371,AGAINST THE PROPOSAL - NO,140058,8,11,161,180
CLEVELAND,STATE QUESTION NO. 794 LEGISLATIVE REFERENDUM NO. 371,FOR THE PROPOSAL - YES,140059,34,26,272,332
CLEVELAND,STATE QUESTION NO. 794 LEGISLATIVE REFERENDUM NO. 371,AGAINST THE PROPOSAL - NO,140059,9,9,118,136
CLEVELAND,STATE QUESTION NO. 794 LEGISLATIVE REFERENDUM NO. 371,FOR THE PROPOSAL - YES,140060,122,159,1218,1499
CLEVELAND,STATE QUESTION NO. 794 LEGISLATIVE REFERENDUM NO. 371,AGAINST THE PROPOSAL - NO,140060,27,35,284,346
CLEVELAND,STATE QUESTION NO. 794 LEGISLATIVE REFERENDUM NO. 371,FOR THE PROPOSAL - YES,140061,165,177,818,1160
CLEVELAND,STATE QUESTION NO. 794 LEGISLATIVE REFERENDUM NO. 371,AGAINST THE PROPOSAL - NO,140061,45,28,200,273
CLEVELAND,STATE QUESTION NO. 794 LEGISLATIVE REFERENDUM NO. 371,FOR THE PROPOSAL - YES,140063,34,63,394,491
CLEVELAND,STATE QUESTION NO. 794 LEGISLATIVE REFERENDUM NO. 371,AGAINST THE PROPOSAL - NO,140063,8,12,99,119
CLEVELAND,STATE QUESTION NO. 794 LEGISLATIVE REFERENDUM NO. 371,FOR THE PROPOSAL - YES,140064,123,48,797,968
CLEVELAND,STATE QUESTION NO. 794 LEGISLATIVE REFERENDUM NO. 371,AGAINST THE PROPOSAL - NO,140064,16,13,156,185
CLEVELAND,STATE QUESTION NO. 794 LEGISLATIVE REFERENDUM NO. 371,FOR THE PROPOSAL - YES,140065,23,18,470,511
CLEVELAND,STATE QUESTION NO. 794 LEGISLATIVE REFERENDUM NO. 371,AGAINST THE PROPOSAL - NO,140065,8,4,118,130
CLEVELAND,STATE QUESTION NO. 794 LEGISLATIVE REFERENDUM NO. 371,FOR THE PROPOSAL - YES,140067,49,68,552,669
CLEVELAND,STATE QUESTION NO. 794 LEGISLATIVE REFERENDUM NO. 371,AGAINST THE PROPOSAL - NO,140067,9,30,186,225
CLEVELAND,STATE QUESTION NO. 794 LEGISLATIVE REFERENDUM NO. 371,FOR THE PROPOSAL - YES,140068,47,50,701,798
CLEVELAND,STATE QUESTION NO. 794 LEGISLATIVE REFERENDUM NO. 371,AGAINST THE PROPOSAL - NO,140068,15,27,270,312
CLEVELAND,STATE QUESTION NO. 794 LEGISLATIVE REFERENDUM NO. 371,FOR THE PROPOSAL - YES,140069,71,123,1074,1268
CLEVELAND,STATE QUESTION NO. 794 LEGISLATIVE REFERENDUM NO. 371,AGAINST THE PROPOSAL - NO,140069,17,17,288,322
CLEVELAND,STATE QUESTION NO. 794 LEGISLATIVE REFERENDUM NO. 371,FOR THE PROPOSAL - YES,140070,61,85,762,908
CLEVELAND,STATE QUESTION NO. 794 LEGISLATIVE REFERENDUM NO. 371,AGAINST THE PROPOSAL - NO,140070,17,13,216,246
CLEVELAND,STATE QUESTION NO. 794 LEGISLATIVE REFERENDUM NO. 371,FOR THE PROPOSAL - YES,140071,40,46,388,474
CLEVELAND,STATE QUESTION NO. 794 LEGISLATIVE REFERENDUM NO. 371,AGAINST THE PROPOSAL - NO,140071,16,15,132,163
CLEVELAND,STATE QUESTION NO. 794 LEGISLATIVE REFERENDUM NO. 371,FOR THE PROPOSAL - YES,140072,102,119,1000,1221
CLEVELAND,STATE QUESTION NO. 794 LEGISLATIVE REFERENDUM NO. 371,AGAINST THE PROPOSAL - NO,140072,32,27,300,359
CLEVELAND,STATE QUESTION NO. 794 LEGISLATIVE REFERENDUM NO. 371,FOR THE PROPOSAL - YES,140073,220,257,1375,1852
CLEVELAND,STATE QUESTION NO. 794 LEGISLATIVE REFERENDUM NO. 371,AGAINST THE PROPOSAL - NO,140073,78,84,539,701
CLEVELAND,STATE QUESTION NO. 794 LEGISLATIVE REFERENDUM NO. 371,FOR THE PROPOSAL - YES,140074,49,70,564,683
CLEVELAND,STATE QUESTION NO. 794 LEGISLATIVE REFERENDUM NO. 371,AGAINST THE PROPOSAL - NO,140074,22,27,179,228
CLEVELAND,STATE QUESTION NO. 794 LEGISLATIVE REFERENDUM NO. 371,FOR THE PROPOSAL - YES,140076,34,70,544,648
CLEVELAND,STATE QUESTION NO. 794 LEGISLATIVE REFERENDUM NO. 371,AGAINST THE PROPOSAL - NO,140076,12,30,189,231
CLEVELAND,STATE QUESTION NO. 794 LEGISLATIVE REFERENDUM NO. 371,FOR THE PROPOSAL - YES,140077,10,9,173,192
CLEVELAND,STATE QUESTION NO. 794 LEGISLATIVE REFERENDUM NO. 371,AGAINST THE PROPOSAL - NO,140077,0,4,72,76
CLEVELAND,STATE QUESTION NO. 794 LEGISLATIVE REFERENDUM NO. 371,FOR THE PROPOSAL - YES,140078,87,39,911,1037
CLEVELAND,STATE QUESTION NO. 794 LEGISLATIVE REFERENDUM NO. 371,AGAINST THE PROPOSAL - NO,140078,26,6,196,228
CLEVELAND,STATE QUESTION NO. 794 LEGISLATIVE REFERENDUM NO. 371,FOR THE PROPOSAL - YES,140080,16,8,217,241
CLEVELAND,STATE QUESTION NO. 794 LEGISLATIVE REFERENDUM NO. 371,AGAINST THE PROPOSAL - NO,140080,5,5,41,51
CLEVELAND,STATE QUESTION NO. 794 LEGISLATIVE REFERENDUM NO. 371,FOR THE PROPOSAL - YES,140081,96,151,855,1102
CLEVELAND,STATE QUESTION NO. 794 LEGISLATIVE REFERENDUM NO. 371,AGAINST THE PROPOSAL - NO,140081,29,57,349,435
CLEVELAND,STATE QUESTION NO. 794 LEGISLATIVE REFERENDUM NO. 371,FOR THE PROPOSAL - YES,140082,119,237,965,1321
CLEVELAND,STATE QUESTION NO. 794 LEGISLATIVE REFERENDUM NO. 371,AGAINST THE PROPOSAL - NO,140082,38,63,329,430
CLEVELAND,STATE QUESTION NO. 794 LEGISLATIVE REFERENDUM NO. 371,FOR THE PROPOSAL - YES,140083,17,15,256,288
CLEVELAND,STATE QUESTION NO. 794 LEGISLATIVE REFERENDUM NO. 371,AGAINST THE PROPOSAL - NO,140083,4,6,81,91
CLEVELAND,STATE QUESTION NO. 794 LEGISLATIVE REFERENDUM NO. 371,FOR THE PROPOSAL - YES,140086,86,185,798,1069
CLEVELAND,STATE QUESTION NO. 794 LEGISLATIVE REFERENDUM NO. 371,AGAINST THE PROPOSAL - NO,140086,16,55,233,304
CLEVELAND,STATE QUESTION NO. 794 LEGISLATIVE REFERENDUM NO. 371,FOR THE PROPOSAL - YES,140087,38,19,430,487
CLEVELAND,STATE QUESTION NO. 794 LEGISLATIVE REFERENDUM NO. 371,AGAINST THE PROPOSAL - NO,140087,4,3,110,117
CLEVELAND,STATE QUESTION NO. 794 LEGISLATIVE REFERENDUM NO. 371,FOR THE PROPOSAL - YES,140088,137,238,1008,1383
CLEVELAND,STATE QUESTION NO. 794 LEGISLATIVE REFERENDUM NO. 371,AGAINST THE PROPOSAL - NO,140088,19,58,271,348
CLEVELAND,STATE QUESTION NO. 794 LEGISLATIVE REFERENDUM NO. 371,FOR THE PROPOSAL - YES,140089,149,199,1032,1380
CLEVELAND,STATE QUESTION NO. 794 LEGISLATIVE REFERENDUM NO. 371,AGAINST THE PROPOSAL - NO,140089,31,53,312,396
CLEVELAND,STATE QUESTION NO. 794 LEGISLATIVE REFERENDUM NO. 371,FOR THE PROPOSAL - YES,140090,0,0,0,0
CLEVELAND,STATE QUESTION NO. 794 LEGISLATIVE REFERENDUM NO. 371,AGAINST THE PROPOSAL - NO,140090,0,1,0,1
CLEVELAND,STATE QUESTION NO. 794 LEGISLATIVE REFERENDUM NO. 371,FOR THE PROPOSAL - YES,140091,18,28,75,121
CLEVELAND,STATE QUESTION NO. 794 LEGISLATIVE REFERENDUM NO. 371,AGAINST THE PROPOSAL - NO,140091,6,7,27,40
CLEVELAND,STATE QUESTION NO. 794 LEGISLATIVE REFERENDUM NO. 371,FOR THE PROPOSAL - YES,140092,0,0,6,6
CLEVELAND,STATE QUESTION NO. 794 LEGISLATIVE REFERENDUM NO. 371,AGAINST THE PROPOSAL - NO,140092,0,0,0,0
CLEVELAND,STATE QUESTION NO. 794 LEGISLATIVE REFERENDUM NO. 371,FOR THE PROPOSAL - YES,140093,28,40,289,357
CLEVELAND,STATE QUESTION NO. 794 LEGISLATIVE REFERENDUM NO. 371,AGAINST THE PROPOSAL - NO,140093,6,23,130,159
CLEVELAND,STATE QUESTION NO. 794 LEGISLATIVE REFERENDUM NO. 371,FOR THE PROPOSAL - YES,140094,22,19,174,215
CLEVELAND,STATE QUESTION NO. 794 LEGISLATIVE REFERENDUM NO. 371,AGAINST THE PROPOSAL - NO,140094,9,8,43,60
CLEVELAND,STATE QUESTION NO. 794 LEGISLATIVE REFERENDUM NO. 371,FOR THE PROPOSAL - YES,140095,14,11,293,318
CLEVELAND,STATE QUESTION NO. 794 LEGISLATIVE REFERENDUM NO. 371,AGAINST THE PROPOSAL - NO,140095,5,1,76,82
COAL,STATE QUESTION NO. 794 LEGISLATIVE REFERENDUM NO. 371,FOR THE PROPOSAL - YES,150002,1,13,193,207
COAL,STATE QUESTION NO. 794 LEGISLATIVE REFERENDUM NO. 371,AGAINST THE PROPOSAL - NO,150002,2,5,65,72
COAL,STATE QUESTION NO. 794 LEGISLATIVE REFERENDUM NO. 371,FOR THE PROPOSAL - YES,150003,3,10,100,113
COAL,STATE QUESTION NO. 794 LEGISLATIVE REFERENDUM NO. 371,AGAINST THE PROPOSAL - NO,150003,0,2,33,35
COAL,STATE QUESTION NO. 794 LEGISLATIVE REFERENDUM NO. 371,FOR THE PROPOSAL - YES,150004,9,47,151,207
COAL,STATE QUESTION NO. 794 LEGISLATIVE REFERENDUM NO. 371,AGAINST THE PROPOSAL - NO,150004,1,14,59,74
COAL,STATE QUESTION NO. 794 LEGISLATIVE REFERENDUM NO. 371,FOR THE PROPOSAL - YES,150005,5,48,154,207
COAL,STATE QUESTION NO. 794 LEGISLATIVE REFERENDUM NO. 371,AGAINST THE PROPOSAL - NO,150005,2,8,48,58
COAL,STATE QUESTION NO. 794 LEGISLATIVE REFERENDUM NO. 371,FOR THE PROPOSAL - YES,150006,5,15,61,81
COAL,STATE QUESTION NO. 794 LEGISLATIVE REFERENDUM NO. 371,AGAINST THE PROPOSAL - NO,150006,0,7,15,22
COAL,STATE QUESTION NO. 794 LEGISLATIVE REFERENDUM NO. 371,FOR THE PROPOSAL - YES,150007,4,25,142,171
COAL,STATE QUESTION NO. 794 LEGISLATIVE REFERENDUM NO. 371,AGAINST THE PROPOSAL - NO,150007,0,10,37,47
COAL,STATE QUESTION NO. 794 LEGISLATIVE REFERENDUM NO. 371,FOR THE PROPOSAL - YES,150009,1,4,65,70
COAL,STATE QUESTION NO. 794 LEGISLATIVE REFERENDUM NO. 371,AGAINST THE PROPOSAL - NO,150009,0,0,12,12
COAL,STATE QUESTION NO. 794 LEGISLATIVE REFERENDUM NO. 371,FOR THE PROPOSAL - YES,150010,4,8,78,90
COAL,STATE QUESTION NO. 794 LEGISLATIVE REFERENDUM NO. 371,AGAINST THE PROPOSAL - NO,150010,0,8,24,32
COAL,STATE QUESTION NO. 794 LEGISLATIVE REFERENDUM NO. 371,FOR THE PROPOSAL - YES,150011,2,21,165,188
COAL,STATE QUESTION NO. 794 LEGISLATIVE REFERENDUM NO. 371,AGAINST THE PROPOSAL - NO,150011,1,5,45,51
COMANCHE,STATE QUESTION NO. 794 LEGISLATIVE REFERENDUM NO. 371,FOR THE PROPOSAL - YES,160001,64,81,700,845
COMANCHE,STATE QUESTION NO. 794 LEGISLATIVE REFERENDUM NO. 371,AGAINST THE PROPOSAL - NO,160001,14,21,143,178
COMANCHE,STATE QUESTION NO. 794 LEGISLATIVE REFERENDUM NO. 371,FOR THE PROPOSAL - YES,160002,38,84,553,675
COMANCHE,STATE QUESTION NO. 794 LEGISLATIVE REFERENDUM NO. 371,AGAINST THE PROPOSAL - NO,160002,7,18,124,149
COMANCHE,STATE QUESTION NO. 794 LEGISLATIVE REFERENDUM NO. 371,FOR THE PROPOSAL - YES,160003,31,55,471,557
COMANCHE,STATE QUESTION NO. 794 LEGISLATIVE REFERENDUM NO. 371,AGAINST THE PROPOSAL - NO,160003,9,10,92,111
COMANCHE,STATE QUESTION NO. 794 LEGISLATIVE REFERENDUM NO. 371,FOR THE PROPOSAL - YES,160007,32,90,507,629
COMANCHE,STATE QUESTION NO. 794 LEGISLATIVE REFERENDUM NO. 371,AGAINST THE PROPOSAL - NO,160007,12,13,111,136
COMANCHE,STATE QUESTION NO. 794 LEGISLATIVE REFERENDUM NO. 371,FOR THE PROPOSAL - YES,160008,69,115,762,946
COMANCHE,STATE QUESTION NO. 794 LEGISLATIVE REFERENDUM NO. 371,AGAINST THE PROPOSAL - NO,160008,10,31,180,221
COMANCHE,STATE QUESTION NO. 794 LEGISLATIVE REFERENDUM NO. 371,FOR THE PROPOSAL - YES,160009,33,110,694,837
COMANCHE,STATE QUESTION NO. 794 LEGISLATIVE REFERENDUM NO. 371,AGAINST THE PROPOSAL - NO,160009,7,34,178,219
COMANCHE,STATE QUESTION NO. 794 LEGISLATIVE REFERENDUM NO. 371,FOR THE PROPOSAL - YES,160011,23,80,517,620
COMANCHE,STATE QUESTION NO. 794 LEGISLATIVE REFERENDUM NO. 371,AGAINST THE PROPOSAL - NO,160011,3,25,131,159
COMANCHE,STATE QUESTION NO. 794 LEGISLATIVE REFERENDUM NO. 371,FOR THE PROPOSAL - YES,160013,22,46,633,701
COMANCHE,STATE QUESTION NO. 794 LEGISLATIVE REFERENDUM NO. 371,AGAINST THE PROPOSAL - NO,160013,9,10,139,158
COMANCHE,STATE QUESTION NO. 794 LEGISLATIVE REFERENDUM NO. 371,FOR THE PROPOSAL - YES,160014,9,3,64,76
COMANCHE,STATE QUESTION NO. 794 LEGISLATIVE REFERENDUM NO. 371,AGAINST THE PROPOSAL - NO,160014,1,4,17,22
COMANCHE,STATE QUESTION NO. 794 LEGISLATIVE REFERENDUM NO. 371,FOR THE PROPOSAL - YES,160015,38,83,505,626
COMANCHE,STATE QUESTION NO. 794 LEGISLATIVE REFERENDUM NO. 371,AGAINST THE PROPOSAL - NO,160015,10,16,124,150
COMANCHE,STATE QUESTION NO. 794 LEGISLATIVE REFERENDUM NO. 371,FOR THE PROPOSAL - YES,160017,33,72,530,635
COMANCHE,STATE QUESTION NO. 794 LEGISLATIVE REFERENDUM NO. 371,AGAINST THE PROPOSAL - NO,160017,20,24,116,160
COMANCHE,STATE QUESTION NO. 794 LEGISLATIVE REFERENDUM NO. 371,FOR THE PROPOSAL - YES,160019,13,36,400,449
COMANCHE,STATE QUESTION NO. 794 LEGISLATIVE REFERENDUM NO. 371,AGAINST THE PROPOSAL - NO,160019,7,12,131,150
COMANCHE,STATE QUESTION NO. 794 LEGISLATIVE REFERENDUM NO. 371,FOR THE PROPOSAL - YES,160020,23,37,426,486
COMANCHE,STATE QUESTION NO. 794 LEGISLATIVE REFERENDUM NO. 371,AGAINST THE PROPOSAL - NO,160020,5,14,95,114
COMANCHE,STATE QUESTION NO. 794 LEGISLATIVE REFERENDUM NO. 371,FOR THE PROPOSAL - YES,160021,11,41,272,324
COMANCHE,STATE QUESTION NO. 794 LEGISLATIVE REFERENDUM NO. 371,AGAINST THE PROPOSAL - NO,160021,3,24,86,113
COMANCHE,STATE QUESTION NO. 794 LEGISLATIVE REFERENDUM NO. 371,FOR THE PROPOSAL - YES,160025,9,22,205,236
COMANCHE,STATE QUESTION NO. 794 LEGISLATIVE REFERENDUM NO. 371,AGAINST THE PROPOSAL - NO,160025,2,4,52,58
COMANCHE,STATE QUESTION NO. 794 LEGISLATIVE REFERENDUM NO. 371,FOR THE PROPOSAL - YES,160026,2,13,235,250
COMANCHE,STATE QUESTION NO. 794 LEGISLATIVE REFERENDUM NO. 371,AGAINST THE PROPOSAL - NO,160026,0,4,47,51
COMANCHE,STATE QUESTION NO. 794 LEGISLATIVE REFERENDUM NO. 371,FOR THE PROPOSAL - YES,160027,9,21,214,244
COMANCHE,STATE QUESTION NO. 794 LEGISLATIVE REFERENDUM NO. 371,AGAINST THE PROPOSAL - NO,160027,1,4,49,54
COMANCHE,STATE QUESTION NO. 794 LEGISLATIVE REFERENDUM NO. 371,FOR THE PROPOSAL - YES,160029,7,11,145,163
COMANCHE,STATE QUESTION NO. 794 LEGISLATIVE REFERENDUM NO. 371,AGAINST THE PROPOSAL - NO,160029,2,2,30,34
COMANCHE,STATE QUESTION NO. 794 LEGISLATIVE REFERENDUM NO. 371,FOR THE PROPOSAL - YES,160030,2,12,165,179
COMANCHE,STATE QUESTION NO. 794 LEGISLATIVE REFERENDUM NO. 371,AGAINST THE PROPOSAL - NO,160030,1,2,37,40
COMANCHE,STATE QUESTION NO. 794 LEGISLATIVE REFERENDUM NO. 371,FOR THE PROPOSAL - YES,160031,103,399,1055,1557
COMANCHE,STATE QUESTION NO. 794 LEGISLATIVE REFERENDUM NO. 371,AGAINST THE PROPOSAL - NO,160031,34,85,244,363
COMANCHE,STATE QUESTION NO. 794 LEGISLATIVE REFERENDUM NO. 371,FOR THE PROPOSAL - YES,160032,1,2,41,44
COMANCHE,STATE QUESTION NO. 794 LEGISLATIVE REFERENDUM NO. 371,AGAINST THE PROPOSAL - NO,160032,0,1,17,18
COMANCHE,STATE QUESTION NO. 794 LEGISLATIVE REFERENDUM NO. 371,FOR THE PROPOSAL - YES,160033,37,26,207,270
COMANCHE,STATE QUESTION NO. 794 LEGISLATIVE REFERENDUM NO. 371,AGAINST THE PROPOSAL - NO,160033,2,8,57,67
COMANCHE,STATE QUESTION NO. 794 LEGISLATIVE REFERENDUM NO. 371,FOR THE PROPOSAL - YES,160034,33,119,705,857
COMANCHE,STATE QUESTION NO. 794 LEGISLATIVE REFERENDUM NO. 371,AGAINST THE PROPOSAL - NO,160034,9,38,183,230
COMANCHE,STATE QUESTION NO. 794 LEGISLATIVE REFERENDUM NO. 371,FOR THE PROPOSAL - YES,160035,16,20,219,255
COMANCHE,STATE QUESTION NO. 794 LEGISLATIVE REFERENDUM NO. 371,AGAINST THE PROPOSAL - NO,160035,3,5,62,70
COMANCHE,STATE QUESTION NO. 794 LEGISLATIVE REFERENDUM NO. 371,FOR THE PROPOSAL - YES,160036,10,19,218,247
COMANCHE,STATE QUESTION NO. 794 LEGISLATIVE REFERENDUM NO. 371,AGAINST THE PROPOSAL - NO,160036,5,3,61,69
COMANCHE,STATE QUESTION NO. 794 LEGISLATIVE REFERENDUM NO. 371,FOR THE PROPOSAL - YES,160037,5,2,170,177
COMANCHE,STATE QUESTION NO. 794 LEGISLATIVE REFERENDUM NO. 371,AGAINST THE PROPOSAL - NO,160037,2,5,43,50
COMANCHE,STATE QUESTION NO. 794 LEGISLATIVE REFERENDUM NO. 371,FOR THE PROPOSAL - YES,160038,63,458,784,1305
COMANCHE,STATE QUESTION NO. 794 LEGISLATIVE REFERENDUM NO. 371,AGAINST THE PROPOSAL - NO,160038,15,105,216,336
COMANCHE,STATE QUESTION NO. 794 LEGISLATIVE REFERENDUM NO. 371,FOR THE PROPOSAL - YES,160039,15,58,482,555
COMANCHE,STATE QUESTION NO. 794 LEGISLATIVE REFERENDUM NO. 371,AGAINST THE PROPOSAL - NO,160039,4,12,123,139
COMANCHE,STATE QUESTION NO. 794 LEGISLATIVE REFERENDUM NO. 371,FOR THE PROPOSAL - YES,160040,8,44,587,639
COMANCHE,STATE QUESTION NO. 794 LEGISLATIVE REFERENDUM NO. 371,AGAINST THE PROPOSAL - NO,160040,2,7,134,143
COMANCHE,STATE QUESTION NO. 794 LEGISLATIVE REFERENDUM NO. 371,FOR THE PROPOSAL - YES,160041,10,9,340,359
COMANCHE,STATE QUESTION NO. 794 LEGISLATIVE REFERENDUM NO. 371,AGAINST THE PROPOSAL - NO,160041,1,7,74,82
COMANCHE,STATE QUESTION NO. 794 LEGISLATIVE REFERENDUM NO. 371,FOR THE PROPOSAL - YES,160042,132,165,1143,1440
COMANCHE,STATE QUESTION NO. 794 LEGISLATIVE REFERENDUM NO. 371,AGAINST THE PROPOSAL - NO,160042,27,35,294,356
COMANCHE,STATE QUESTION NO. 794 LEGISLATIVE REFERENDUM NO. 371,FOR THE PROPOSAL - YES,160043,6,13,195,214
COMANCHE,STATE QUESTION NO. 794 LEGISLATIVE REFERENDUM NO. 371,AGAINST THE PROPOSAL - NO,160043,4,4,44,52
COMANCHE,STATE QUESTION NO. 794 LEGISLATIVE REFERENDUM NO. 371,FOR THE PROPOSAL - YES,160045,31,61,506,598
COMANCHE,STATE QUESTION NO. 794 LEGISLATIVE REFERENDUM NO. 371,AGAINST THE PROPOSAL - NO,160045,1,7,124,132
COMANCHE,STATE QUESTION NO. 794 LEGISLATIVE REFERENDUM NO. 371,FOR THE PROPOSAL - YES,160046,5,3,182,190
COMANCHE,STATE QUESTION NO. 794 LEGISLATIVE REFERENDUM NO. 371,AGAINST THE PROPOSAL - NO,160046,1,6,69,76
COMANCHE,STATE QUESTION NO. 794 LEGISLATIVE REFERENDUM NO. 371,FOR THE PROPOSAL - YES,160048,6,10,327,343
COMANCHE,STATE QUESTION NO. 794 LEGISLATIVE REFERENDUM NO. 371,AGAINST THE PROPOSAL - NO,160048,2,7,103,112
COMANCHE,STATE QUESTION NO. 794 LEGISLATIVE REFERENDUM NO. 371,FOR THE PROPOSAL - YES,160049,13,18,401,432
COMANCHE,STATE QUESTION NO. 794 LEGISLATIVE REFERENDUM NO. 371,AGAINST THE PROPOSAL - NO,160049,4,6,88,98
COMANCHE,STATE QUESTION NO. 794 LEGISLATIVE REFERENDUM NO. 371,FOR THE PROPOSAL - YES,160050,81,149,865,1095
COMANCHE,STATE QUESTION NO. 794 LEGISLATIVE REFERENDUM NO. 371,AGAINST THE PROPOSAL - NO,160050,26,48,196,270
COMANCHE,STATE QUESTION NO. 794 LEGISLATIVE REFERENDUM NO. 371,FOR THE PROPOSAL - YES,160051,27,45,568,640
COMANCHE,STATE QUESTION NO. 794 LEGISLATIVE REFERENDUM NO. 371,AGAINST THE PROPOSAL - NO,160051,8,14,131,153
COMANCHE,STATE QUESTION NO. 794 LEGISLATIVE REFERENDUM NO. 371,FOR THE PROPOSAL - YES,160053,0,0,0,0
COMANCHE,STATE QUESTION NO. 794 LEGISLATIVE REFERENDUM NO. 371,AGAINST THE PROPOSAL - NO,160053,0,0,0,0
COTTON,STATE QUESTION NO. 794 LEGISLATIVE REFERENDUM NO. 371,FOR THE PROPOSAL - YES,170001,6,15,69,90
COTTON,STATE QUESTION NO. 794 LEGISLATIVE REFERENDUM NO. 371,AGAINST THE PROPOSAL - NO,170001,1,2,10,13
COTTON,STATE QUESTION NO. 794 LEGISLATIVE REFERENDUM NO. 371,FOR THE PROPOSAL - YES,170003,21,49,201,271
COTTON,STATE QUESTION NO. 794 LEGISLATIVE REFERENDUM NO. 371,AGAINST THE PROPOSAL - NO,170003,3,13,70,86
COTTON,STATE QUESTION NO. 794 LEGISLATIVE REFERENDUM NO. 371,FOR THE PROPOSAL - YES,170004,7,30,160,197
COTTON,STATE QUESTION NO. 794 LEGISLATIVE REFERENDUM NO. 371,AGAINST THE PROPOSAL - NO,170004,7,13,50,70
COTTON,STATE QUESTION NO. 794 LEGISLATIVE REFERENDUM NO. 371,FOR THE PROPOSAL - YES,170005,10,31,216,257
COTTON,STATE QUESTION NO. 794 LEGISLATIVE REFERENDUM NO. 371,AGAINST THE PROPOSAL - NO,170005,1,3,74,78
COTTON,STATE QUESTION NO. 794 LEGISLATIVE REFERENDUM NO. 371,FOR THE PROPOSAL - YES,170007,2,32,172,206
COTTON,STATE QUESTION NO. 794 LEGISLATIVE REFERENDUM NO. 371,AGAINST THE PROPOSAL - NO,170007,2,14,49,65
COTTON,STATE QUESTION NO. 794 LEGISLATIVE REFERENDUM NO. 371,FOR THE PROPOSAL - YES,170008,3,6,43,52
COTTON,STATE QUESTION NO. 794 LEGISLATIVE REFERENDUM NO. 371,AGAINST THE PROPOSAL - NO,170008,0,0,5,5
COTTON,STATE QUESTION NO. 794 LEGISLATIVE REFERENDUM NO. 371,FOR THE PROPOSAL - YES,170009,6,36,151,193
COTTON,STATE QUESTION NO. 794 LEGISLATIVE REFERENDUM NO. 371,AGAINST THE PROPOSAL - NO,170009,3,7,52,62
COTTON,STATE QUESTION NO. 794 LEGISLATIVE REFERENDUM NO. 371,FOR THE PROPOSAL - YES,170010,4,3,87,94
COTTON,STATE QUESTION NO. 794 LEGISLATIVE REFERENDUM NO. 371,AGAINST THE PROPOSAL - NO,170010,0,2,32,34
COTTON,STATE QUESTION NO. 794 LEGISLATIVE REFERENDUM NO. 371,FOR THE PROPOSAL - YES,170011,0,6,118,124
COTTON,STATE QUESTION NO. 794 LEGISLATIVE REFERENDUM NO. 371,AGAINST THE PROPOSAL - NO,170011,0,5,52,57
CRAIG,STATE QUESTION NO. 794 LEGISLATIVE REFERENDUM NO. 371,FOR THE PROPOSAL - YES,180140,5,14,403,422
CRAIG,STATE QUESTION NO. 794 LEGISLATIVE REFERENDUM NO. 371,AGAINST THE PROPOSAL - NO,180140,2,5,123,130
CRAIG,STATE QUESTION NO. 794 LEGISLATIVE REFERENDUM NO. 371,FOR THE PROPOSAL - YES,180320,8,11,100,119
CRAIG,STATE QUESTION NO. 794 LEGISLATIVE REFERENDUM NO. 371,AGAINST THE PROPOSAL - NO,180320,5,1,25,31
CRAIG,STATE QUESTION NO. 794 LEGISLATIVE REFERENDUM NO. 371,FOR THE PROPOSAL - YES,180410,3,17,247,267
CRAIG,STATE QUESTION NO. 794 LEGISLATIVE REFERENDUM NO. 371,AGAINST THE PROPOSAL - NO,180410,2,3,75,80
CRAIG,STATE QUESTION NO. 794 LEGISLATIVE REFERENDUM NO. 371,FOR THE PROPOSAL - YES,180520,6,20,251,277
CRAIG,STATE QUESTION NO. 794 LEGISLATIVE REFERENDUM NO. 371,AGAINST THE PROPOSAL - NO,180520,0,3,74,77
CRAIG,STATE QUESTION NO. 794 LEGISLATIVE REFERENDUM NO. 371,FOR THE PROPOSAL - YES,180611,4,30,257,291
CRAIG,STATE QUESTION NO. 794 LEGISLATIVE REFERENDUM NO. 371,AGAINST THE PROPOSAL - NO,180611,1,5,69,75
CRAIG,STATE QUESTION NO. 794 LEGISLATIVE REFERENDUM NO. 371,FOR THE PROPOSAL - YES,180612,7,20,178,205
CRAIG,STATE QUESTION NO. 794 LEGISLATIVE REFERENDUM NO. 371,AGAINST THE PROPOSAL - NO,180612,2,5,54,61
CRAIG,STATE QUESTION NO. 794 LEGISLATIVE REFERENDUM NO. 371,FOR THE PROPOSAL - YES,180621,13,65,399,477
CRAIG,STATE QUESTION NO. 794 LEGISLATIVE REFERENDUM NO. 371,AGAINST THE PROPOSAL - NO,180621,8,11,116,135
CRAIG,STATE QUESTION NO. 794 LEGISLATIVE REFERENDUM NO. 371,FOR THE PROPOSAL - YES,180622,4,26,270,300
CRAIG,STATE QUESTION NO. 794 LEGISLATIVE REFERENDUM NO. 371,AGAINST THE PROPOSAL - NO,180622,5,7,59,71
CRAIG,STATE QUESTION NO. 794 LEGISLATIVE REFERENDUM NO. 371,FOR THE PROPOSAL - YES,180710,16,16,220,252
CRAIG,STATE QUESTION NO. 794 LEGISLATIVE REFERENDUM NO. 371,AGAINST THE PROPOSAL - NO,180710,5,6,70,81
CRAIG,STATE QUESTION NO. 794 LEGISLATIVE REFERENDUM NO. 371,FOR THE PROPOSAL - YES,180810,11,42,340,393
CRAIG,STATE QUESTION NO. 794 LEGISLATIVE REFERENDUM NO. 371,AGAINST THE PROPOSAL - NO,180810,1,1,78,80
CRAIG,STATE QUESTION NO. 794 LEGISLATIVE REFERENDUM NO. 371,FOR THE PROPOSAL - YES,180820,10,34,354,398
CRAIG,STATE QUESTION NO. 794 LEGISLATIVE REFERENDUM NO. 371,AGAINST THE PROPOSAL - NO,180820,3,9,92,104
CRAIG,STATE QUESTION NO. 794 LEGISLATIVE REFERENDUM NO. 371,FOR THE PROPOSAL - YES,180910,8,32,213,253
CRAIG,STATE QUESTION NO. 794 LEGISLATIVE REFERENDUM NO. 371,AGAINST THE PROPOSAL - NO,180910,0,10,73,83
CREEK,STATE QUESTION NO. 794 LEGISLATIVE REFERENDUM NO. 371,FOR THE PROPOSAL - YES,190111,14,76,411,501
CREEK,STATE QUESTION NO. 794 LEGISLATIVE REFERENDUM NO. 371,AGAINST THE PROPOSAL - NO,190111,3,10,128,141
CREEK,STATE QUESTION NO. 794 LEGISLATIVE REFERENDUM NO. 371,FOR THE PROPOSAL - YES,190112,5,14,142,161
CREEK,STATE QUESTION NO. 794 LEGISLATIVE REFERENDUM NO. 371,AGAINST THE PROPOSAL - NO,190112,0,4,42,46
CREEK,STATE QUESTION NO. 794 LEGISLATIVE REFERENDUM NO. 371,FOR THE PROPOSAL - YES,190121,25,102,636,763
CREEK,STATE QUESTION NO. 794 LEGISLATIVE REFERENDUM NO. 371,AGAINST THE PROPOSAL - NO,190121,2,21,168,191
CREEK,STATE QUESTION NO. 794 LEGISLATIVE REFERENDUM NO. 371,FOR THE PROPOSAL - YES,190122,3,16,146,165
CREEK,STATE QUESTION NO. 794 LEGISLATIVE REFERENDUM NO. 371,AGAINST THE PROPOSAL - NO,190122,1,3,37,41
CREEK,STATE QUESTION NO. 794 LEGISLATIVE REFERENDUM NO. 371,FOR THE PROPOSAL - YES,190131,10,45,262,317
CREEK,STATE QUESTION NO. 794 LEGISLATIVE REFERENDUM NO. 371,AGAINST THE PROPOSAL - NO,190131,4,9,65,78
CREEK,STATE QUESTION NO. 794 LEGISLATIVE REFERENDUM NO. 371,FOR THE PROPOSAL - YES,190132,28,113,456,597
CREEK,STATE QUESTION NO. 794 LEGISLATIVE REFERENDUM NO. 371,AGAINST THE PROPOSAL - NO,190132,9,24,102,135
CREEK,STATE QUESTION NO. 794 LEGISLATIVE REFERENDUM NO. 371,FOR THE PROPOSAL - YES,190142,43,261,964,1268
CREEK,STATE QUESTION NO. 794 LEGISLATIVE REFERENDUM NO. 371,AGAINST THE PROPOSAL - NO,190142,10,69,239,318
CREEK,STATE QUESTION NO. 794 LEGISLATIVE REFERENDUM NO. 371,FOR THE PROPOSAL - YES,190143,13,93,415,521
CREEK,STATE QUESTION NO. 794 LEGISLATIVE REFERENDUM NO. 371,AGAINST THE PROPOSAL - NO,190143,9,22,98,129
CREEK,STATE QUESTION NO. 794 LEGISLATIVE REFERENDUM NO. 371,FOR THE PROPOSAL - YES,190211,8,6,219,233
CREEK,STATE QUESTION NO. 794 LEGISLATIVE REFERENDUM NO. 371,AGAINST THE PROPOSAL - NO,190211,2,2,68,72
CREEK,STATE QUESTION NO. 794 LEGISLATIVE REFERENDUM NO. 371,FOR THE PROPOSAL - YES,190221,4,4,179,187
CREEK,STATE QUESTION NO. 794 LEGISLATIVE REFERENDUM NO. 371,AGAINST THE PROPOSAL - NO,190221,1,0,49,50
CREEK,STATE QUESTION NO. 794 LEGISLATIVE REFERENDUM NO. 371,FOR THE PROPOSAL - YES,190231,6,8,247,261
CREEK,STATE QUESTION NO. 794 LEGISLATIVE REFERENDUM NO. 371,AGAINST THE PROPOSAL - NO,190231,2,0,88,90
CREEK,STATE QUESTION NO. 794 LEGISLATIVE REFERENDUM NO. 371,FOR THE PROPOSAL - YES,190241,8,6,241,255
CREEK,STATE QUESTION NO. 794 LEGISLATIVE REFERENDUM NO. 371,AGAINST THE PROPOSAL - NO,190241,4,3,103,110
CREEK,STATE QUESTION NO. 794 LEGISLATIVE REFERENDUM NO. 371,FOR THE PROPOSAL - YES,190311,16,12,491,519
CREEK,STATE QUESTION NO. 794 LEGISLATIVE REFERENDUM NO. 371,AGAINST THE PROPOSAL - NO,190311,5,3,128,136
CREEK,STATE QUESTION NO. 794 LEGISLATIVE REFERENDUM NO. 371,FOR THE PROPOSAL - YES,190401,17,66,397,480
CREEK,STATE QUESTION NO. 794 LEGISLATIVE REFERENDUM NO. 371,AGAINST THE PROPOSAL - NO,190401,1,22,125,148
CREEK,STATE QUESTION NO. 794 LEGISLATIVE REFERENDUM NO. 371,FOR THE PROPOSAL - YES,190402,19,107,384,510
CREEK,STATE QUESTION NO. 794 LEGISLATIVE REFERENDUM NO. 371,AGAINST THE PROPOSAL - NO,190402,6,24,138,168
CREEK,STATE QUESTION NO. 794 LEGISLATIVE REFERENDUM NO. 371,FOR THE PROPOSAL - YES,190403,21,57,489,567
CREEK,STATE QUESTION NO. 794 LEGISLATIVE REFERENDUM NO. 371,AGAINST THE PROPOSAL - NO,190403,3,13,124,140
CREEK,STATE QUESTION NO. 794 LEGISLATIVE REFERENDUM NO. 371,FOR THE PROPOSAL - YES,190404,63,52,1009,1124
CREEK,STATE QUESTION NO. 794 LEGISLATIVE REFERENDUM NO. 371,AGAINST THE PROPOSAL - NO,190404,11,23,296,330
CREEK,STATE QUESTION NO. 794 LEGISLATIVE REFERENDUM NO. 371,FOR THE PROPOSAL - YES,190405,35,36,551,622
CREEK,STATE QUESTION NO. 794 LEGISLATIVE REFERENDUM NO. 371,AGAINST THE PROPOSAL - NO,190405,7,6,147,160
CREEK,STATE QUESTION NO. 794 LEGISLATIVE REFERENDUM NO. 371,FOR THE PROPOSAL - YES,190406,8,5,334,347
CREEK,STATE QUESTION NO. 794 LEGISLATIVE REFERENDUM NO. 371,AGAINST THE PROPOSAL - NO,190406,3,1,87,91
CREEK,STATE QUESTION NO. 794 LEGISLATIVE REFERENDUM NO. 371,FOR THE PROPOSAL - YES,190407,2,11,200,213
CREEK,STATE QUESTION NO. 794 LEGISLATIVE REFERENDUM NO. 371,AGAINST THE PROPOSAL - NO,190407,1,1,44,46
CREEK,STATE QUESTION NO. 794 LEGISLATIVE REFERENDUM NO. 371,FOR THE PROPOSAL - YES,190408,6,9,249,264
CREEK,STATE QUESTION NO. 794 LEGISLATIVE REFERENDUM NO. 371,AGAINST THE PROPOSAL - NO,190408,1,2,55,58
CREEK,STATE QUESTION NO. 794 LEGISLATIVE REFERENDUM NO. 371,FOR THE PROPOSAL - YES,190409,11,25,537,573
CREEK,STATE QUESTION NO. 794 LEGISLATIVE REFERENDUM NO. 371,AGAINST THE PROPOSAL - NO,190409,2,12,151,165
CREEK,STATE QUESTION NO. 794 LEGISLATIVE REFERENDUM NO. 371,FOR THE PROPOSAL - YES,190410,5,4,131,140
CREEK,STATE QUESTION NO. 794 LEGISLATIVE REFERENDUM NO. 371,AGAINST THE PROPOSAL - NO,190410,1,0,44,45
CREEK,STATE QUESTION NO. 794 LEGISLATIVE REFERENDUM NO. 371,FOR THE PROPOSAL - YES,190411,3,16,273,292
CREEK,STATE QUESTION NO. 794 LEGISLATIVE REFERENDUM NO. 371,AGAINST THE PROPOSAL - NO,190411,2,3,103,108
CREEK,STATE QUESTION NO. 794 LEGISLATIVE REFERENDUM NO. 371,FOR THE PROPOSAL - YES,190412,10,17,261,288
CREEK,STATE QUESTION NO. 794 LEGISLATIVE REFERENDUM NO. 371,AGAINST THE PROPOSAL - NO,190412,5,3,110,118
CREEK,STATE QUESTION NO. 794 LEGISLATIVE REFERENDUM NO. 371,FOR THE PROPOSAL - YES,190413,14,19,471,504
CREEK,STATE QUESTION NO. 794 LEGISLATIVE REFERENDUM NO. 371,AGAINST THE PROPOSAL - NO,190413,2,7,138,147
CREEK,STATE QUESTION NO. 794 LEGISLATIVE REFERENDUM NO. 371,FOR THE PROPOSAL - YES,190414,39,171,835,1045
CREEK,STATE QUESTION NO. 794 LEGISLATIVE REFERENDUM NO. 371,AGAINST THE PROPOSAL - NO,190414,11,30,234,275
CREEK,STATE QUESTION NO. 794 LEGISLATIVE REFERENDUM NO. 371,FOR THE PROPOSAL - YES,190415,4,23,253,280
CREEK,STATE QUESTION NO. 794 LEGISLATIVE REFERENDUM NO. 371,AGAINST THE PROPOSAL - NO,190415,0,5,55,60
CREEK,STATE QUESTION NO. 794 LEGISLATIVE REFERENDUM NO. 371,FOR THE PROPOSAL - YES,190416,9,24,482,515
CREEK,STATE QUESTION NO. 794 LEGISLATIVE REFERENDUM NO. 371,AGAINST THE PROPOSAL - NO,190416,2,3,138,143
CREEK,STATE QUESTION NO. 794 LEGISLATIVE REFERENDUM NO. 371,FOR THE PROPOSAL - YES,190417,30,173,932,1135
CREEK,STATE QUESTION NO. 794 LEGISLATIVE REFERENDUM NO. 371,AGAINST THE PROPOSAL - NO,190417,7,41,233,281
CREEK,STATE QUESTION NO. 794 LEGISLATIVE REFERENDUM NO. 371,FOR THE PROPOSAL - YES,190418,37,155,635,827
CREEK,STATE QUESTION NO. 794 LEGISLATIVE REFERENDUM NO. 371,AGAINST THE PROPOSAL - NO,190418,11,52,153,216
CREEK,STATE QUESTION NO. 794 LEGISLATIVE REFERENDUM NO. 371,FOR THE PROPOSAL - YES,190419,24,70,565,659
CREEK,STATE QUESTION NO. 794 LEGISLATIVE REFERENDUM NO. 371,AGAINST THE PROPOSAL - NO,190419,4,16,144,164
CREEK,STATE QUESTION NO. 794 LEGISLATIVE REFERENDUM NO. 371,FOR THE PROPOSAL - YES,190420,20,22,373,415
CREEK,STATE QUESTION NO. 794 LEGISLATIVE REFERENDUM NO. 371,AGAINST THE PROPOSAL - NO,190420,7,3,92,102
CREEK,STATE QUESTION NO. 794 LEGISLATIVE REFERENDUM NO. 371,FOR THE PROPOSAL - YES,190421,45,52,534,631
CREEK,STATE QUESTION NO. 794 LEGISLATIVE REFERENDUM NO. 371,AGAINST THE PROPOSAL - NO,190421,13,8,142,163
CREEK,STATE QUESTION NO. 794 LEGISLATIVE REFERENDUM NO. 371,FOR THE PROPOSAL - YES,190422,20,25,289,334
CREEK,STATE QUESTION NO. 794 LEGISLATIVE REFERENDUM NO. 371,AGAINST THE PROPOSAL - NO,190422,2,5,90,97
CUSTER,STATE QUESTION NO. 794 LEGISLATIVE REFERENDUM NO. 371,FOR THE PROPOSAL - YES,200001,15,33,322,370
CUSTER,STATE QUESTION NO. 794 LEGISLATIVE REFERENDUM NO. 371,AGAINST THE PROPOSAL - NO,200001,0,7,67,74
CUSTER,STATE QUESTION NO. 794 LEGISLATIVE REFERENDUM NO. 371,FOR THE PROPOSAL - YES,200003,16,65,476,557
CUSTER,STATE QUESTION NO. 794 LEGISLATIVE REFERENDUM NO. 371,AGAINST THE PROPOSAL - NO,200003,6,16,98,120
CUSTER,STATE QUESTION NO. 794 LEGISLATIVE REFERENDUM NO. 371,FOR THE PROPOSAL - YES,200005,25,97,467,589
CUSTER,STATE QUESTION NO. 794 LEGISLATIVE REFERENDUM NO. 371,AGAINST THE PROPOSAL - NO,200005,6,14,91,111
CUSTER,STATE QUESTION NO. 794 LEGISLATIVE REFERENDUM NO. 371,FOR THE PROPOSAL - YES,200007,22,40,291,353
CUSTER,STATE QUESTION NO. 794 LEGISLATIVE REFERENDUM NO. 371,AGAINST THE PROPOSAL - NO,200007,5,13,61,79
CUSTER,STATE QUESTION NO. 794 LEGISLATIVE REFERENDUM NO. 371,FOR THE PROPOSAL - YES,200012,9,40,312,361
CUSTER,STATE QUESTION NO. 794 LEGISLATIVE REFERENDUM NO. 371,AGAINST THE PROPOSAL - NO,200012,3,11,85,99
CUSTER,STATE QUESTION NO. 794 LEGISLATIVE REFERENDUM NO. 371,FOR THE PROPOSAL - YES,200013,3,16,163,182
CUSTER,STATE QUESTION NO. 794 LEGISLATIVE REFERENDUM NO. 371,AGAINST THE PROPOSAL - NO,200013,0,3,47,50
CUSTER,STATE QUESTION NO. 794 LEGISLATIVE REFERENDUM NO. 371,FOR THE PROPOSAL - YES,200018,40,60,663,763
CUSTER,STATE QUESTION NO. 794 LEGISLATIVE REFERENDUM NO. 371,AGAINST THE PROPOSAL - NO,200018,3,17,164,184
CUSTER,STATE QUESTION NO. 794 LEGISLATIVE REFERENDUM NO. 371,FOR THE PROPOSAL - YES,200019,26,45,626,697
CUSTER,STATE QUESTION NO. 794 LEGISLATIVE REFERENDUM NO. 371,AGAINST THE PROPOSAL - NO,200019,8,21,177,206
CUSTER,STATE QUESTION NO. 794 LEGISLATIVE REFERENDUM NO. 371,FOR THE PROPOSAL - YES,200020,39,57,798,894
CUSTER,STATE QUESTION NO. 794 LEGISLATIVE REFERENDUM NO. 371,AGAINST THE PROPOSAL - NO,200020,4,16,168,188
CUSTER,STATE QUESTION NO. 794 LEGISLATIVE REFERENDUM NO. 371,FOR THE PROPOSAL - YES,200021,24,22,668,714
CUSTER,STATE QUESTION NO. 794 LEGISLATIVE REFERENDUM NO. 371,AGAINST THE PROPOSAL - NO,200021,4,11,183,198
CUSTER,STATE QUESTION NO. 794 LEGISLATIVE REFERENDUM NO. 371,FOR THE PROPOSAL - YES,200022,10,16,187,213
CUSTER,STATE QUESTION NO. 794 LEGISLATIVE REFERENDUM NO. 371,AGAINST THE PROPOSAL - NO,200022,2,5,45,52
CUSTER,STATE QUESTION NO. 794 LEGISLATIVE REFERENDUM NO. 371,FOR THE PROPOSAL - YES,200023,22,22,467,511
CUSTER,STATE QUESTION NO. 794 LEGISLATIVE REFERENDUM NO. 371,AGAINST THE PROPOSAL - NO,200023,3,6,127,136
CUSTER,STATE QUESTION NO. 794 LEGISLATIVE REFERENDUM NO. 371,FOR THE PROPOSAL - YES,200026,14,24,330,368
CUSTER,STATE QUESTION NO. 794 LEGISLATIVE REFERENDUM NO. 371,AGAINST THE PROPOSAL - NO,200026,3,7,97,107
DELAWARE,STATE QUESTION NO. 794 LEGISLATIVE REFERENDUM NO. 371,FOR THE PROPOSAL - YES,210001,36,19,658,713
DELAWARE,STATE QUESTION NO. 794 LEGISLATIVE REFERENDUM NO. 371,AGAINST THE PROPOSAL - NO,210001,16,4,115,135
DELAWARE,STATE QUESTION NO. 794 LEGISLATIVE REFERENDUM NO. 371,FOR THE PROPOSAL - YES,210002,23,4,302,329
DELAWARE,STATE QUESTION NO. 794 LEGISLATIVE REFERENDUM NO. 371,AGAINST THE PROPOSAL - NO,210002,3,1,58,62
DELAWARE,STATE QUESTION NO. 794 LEGISLATIVE REFERENDUM NO. 371,FOR THE PROPOSAL - YES,210003,41,18,626,685
DELAWARE,STATE QUESTION NO. 794 LEGISLATIVE REFERENDUM NO. 371,AGAINST THE PROPOSAL - NO,210003,10,4,121,135
DELAWARE,STATE QUESTION NO. 794 LEGISLATIVE REFERENDUM NO. 371,FOR THE PROPOSAL - YES,210004,22,24,314,360
DELAWARE,STATE QUESTION NO. 794 LEGISLATIVE REFERENDUM NO. 371,AGAINST THE PROPOSAL - NO,210004,6,3,62,71
DELAWARE,STATE QUESTION NO. 794 LEGISLATIVE REFERENDUM NO. 371,FOR THE PROPOSAL - YES,210005,31,42,567,640
DELAWARE,STATE QUESTION NO. 794 LEGISLATIVE REFERENDUM NO. 371,AGAINST THE PROPOSAL - NO,210005,6,8,133,147
DELAWARE,STATE QUESTION NO. 794 LEGISLATIVE REFERENDUM NO. 371,FOR THE PROPOSAL - YES,210006,26,25,450,501
DELAWARE,STATE QUESTION NO. 794 LEGISLATIVE REFERENDUM NO. 371,AGAINST THE PROPOSAL - NO,210006,5,6,110,121
DELAWARE,STATE QUESTION NO. 794 LEGISLATIVE REFERENDUM NO. 371,FOR THE PROPOSAL - YES,210007,117,163,930,1210
DELAWARE,STATE QUESTION NO. 794 LEGISLATIVE REFERENDUM NO. 371,AGAINST THE PROPOSAL - NO,210007,21,24,189,234
DELAWARE,STATE QUESTION NO. 794 LEGISLATIVE REFERENDUM NO. 371,FOR THE PROPOSAL - YES,210008,10,31,219,260
DELAWARE,STATE QUESTION NO. 794 LEGISLATIVE REFERENDUM NO. 371,AGAINST THE PROPOSAL - NO,210008,4,8,57,69
DELAWARE,STATE QUESTION NO. 794 LEGISLATIVE REFERENDUM NO. 371,FOR THE PROPOSAL - YES,210009,63,140,856,1059
DELAWARE,STATE QUESTION NO. 794 LEGISLATIVE REFERENDUM NO. 371,AGAINST THE PROPOSAL - NO,210009,20,29,187,236
DELAWARE,STATE QUESTION NO. 794 LEGISLATIVE REFERENDUM NO. 371,FOR THE PROPOSAL - YES,210010,0,9,21,30
DELAWARE,STATE QUESTION NO. 794 LEGISLATIVE REFERENDUM NO. 371,AGAINST THE PROPOSAL - NO,210010,1,1,2,4
DELAWARE,STATE QUESTION NO. 794 LEGISLATIVE REFERENDUM NO. 371,FOR THE PROPOSAL - YES,210011,35,34,514,583
DELAWARE,STATE QUESTION NO. 794 LEGISLATIVE REFERENDUM NO. 371,AGAINST THE PROPOSAL - NO,210011,2,3,108,113
DELAWARE,STATE QUESTION NO. 794 LEGISLATIVE REFERENDUM NO. 371,FOR THE PROPOSAL - YES,210012,25,46,334,405
DELAWARE,STATE QUESTION NO. 794 LEGISLATIVE REFERENDUM NO. 371,AGAINST THE PROPOSAL - NO,210012,2,8,90,100
DELAWARE,STATE QUESTION NO. 794 LEGISLATIVE REFERENDUM NO. 371,FOR THE PROPOSAL - YES,210014,13,74,272,359
DELAWARE,STATE QUESTION NO. 794 LEGISLATIVE REFERENDUM NO. 371,AGAINST THE PROPOSAL - NO,210014,6,13,122,141
DELAWARE,STATE QUESTION NO. 794 LEGISLATIVE REFERENDUM NO. 371,FOR THE PROPOSAL - YES,210015,26,67,408,501
DELAWARE,STATE QUESTION NO. 794 LEGISLATIVE REFERENDUM NO. 371,AGAINST THE PROPOSAL - NO,210015,3,16,101,120
DELAWARE,STATE QUESTION NO. 794 LEGISLATIVE REFERENDUM NO. 371,FOR THE PROPOSAL - YES,210016,16,49,204,269
DELAWARE,STATE QUESTION NO. 794 LEGISLATIVE REFERENDUM NO. 371,AGAINST THE PROPOSAL - NO,210016,3,7,94,104
DELAWARE,STATE QUESTION NO. 794 LEGISLATIVE REFERENDUM NO. 371,FOR THE PROPOSAL - YES,210017,4,51,145,200
DELAWARE,STATE QUESTION NO. 794 LEGISLATIVE REFERENDUM NO. 371,AGAINST THE PROPOSAL - NO,210017,7,7,55,69
DELAWARE,STATE QUESTION NO. 794 LEGISLATIVE REFERENDUM NO. 371,FOR THE PROPOSAL - YES,210018,8,33,202,243
DELAWARE,STATE QUESTION NO. 794 LEGISLATIVE REFERENDUM NO. 371,AGAINST THE PROPOSAL - NO,210018,2,11,64,77
DELAWARE,STATE QUESTION NO. 794 LEGISLATIVE REFERENDUM NO. 371,FOR THE PROPOSAL - YES,210019,24,32,517,573
DELAWARE,STATE QUESTION NO. 794 LEGISLATIVE REFERENDUM NO. 371,AGAINST THE PROPOSAL - NO,210019,10,6,135,151
DELAWARE,STATE QUESTION NO. 794 LEGISLATIVE REFERENDUM NO. 371,FOR THE PROPOSAL - YES,210020,3,1,124,128
DELAWARE,STATE QUESTION NO. 794 LEGISLATIVE REFERENDUM NO. 371,AGAINST THE PROPOSAL - NO,210020,0,0,20,20
DELAWARE,STATE QUESTION NO. 794 LEGISLATIVE REFERENDUM NO. 371,FOR THE PROPOSAL - YES,210021,1,2,83,86
DELAWARE,STATE QUESTION NO. 794 LEGISLATIVE REFERENDUM NO. 371,AGAINST THE PROPOSAL - NO,210021,0,0,28,28
DELAWARE,STATE QUESTION NO. 794 LEGISLATIVE REFERENDUM NO. 371,FOR THE PROPOSAL - YES,210022,50,47,673,770
DELAWARE,STATE QUESTION NO. 794 LEGISLATIVE REFERENDUM NO. 371,AGAINST THE PROPOSAL - NO,210022,11,17,210,238
DELAWARE,STATE QUESTION NO. 794 LEGISLATIVE REFERENDUM NO. 371,FOR THE PROPOSAL - YES,210023,33,15,370,418
DELAWARE,STATE QUESTION NO. 794 LEGISLATIVE REFERENDUM NO. 371,AGAINST THE PROPOSAL - NO,210023,6,4,109,119
DEWEY,STATE QUESTION NO. 794 LEGISLATIVE REFERENDUM NO. 371,FOR THE PROPOSAL - YES,220001,8,15,146,169
DEWEY,STATE QUESTION NO. 794 LEGISLATIVE REFERENDUM NO. 371,AGAINST THE PROPOSAL - NO,220001,3,8,44,55
DEWEY,STATE QUESTION NO. 794 LEGISLATIVE REFERENDUM NO. 371,FOR THE PROPOSAL - YES,220002,5,1,59,65
DEWEY,STATE QUESTION NO. 794 LEGISLATIVE REFERENDUM NO. 371,AGAINST THE PROPOSAL - NO,220002,0,0,10,10
DEWEY,STATE QUESTION NO. 794 LEGISLATIVE REFERENDUM NO. 371,FOR THE PROPOSAL - YES,220003,6,6,171,183
DEWEY,STATE QUESTION NO. 794 LEGISLATIVE REFERENDUM NO. 371,AGAINST THE PROPOSAL - NO,220003,1,0,76,77
DEWEY,STATE QUESTION NO. 794 LEGISLATIVE REFERENDUM NO. 371,FOR THE PROPOSAL - YES,220004,2,2,82,86
DEWEY,STATE QUESTION NO. 794 LEGISLATIVE REFERENDUM NO. 371,AGAINST THE PROPOSAL - NO,220004,0,1,22,23
DEWEY,STATE QUESTION NO. 794 LEGISLATIVE REFERENDUM NO. 371,FOR THE PROPOSAL - YES,220005,16,26,345,387
DEWEY,STATE QUESTION NO. 794 LEGISLATIVE REFERENDUM NO. 371,AGAINST THE PROPOSAL - NO,220005,3,5,87,95
DEWEY,STATE QUESTION NO. 794 LEGISLATIVE REFERENDUM NO. 371,FOR THE PROPOSAL - YES,220007,3,0,55,58
DEWEY,STATE QUESTION NO. 794 LEGISLATIVE REFERENDUM NO. 371,AGAINST THE PROPOSAL - NO,220007,0,2,11,13
DEWEY,STATE QUESTION NO. 794 LEGISLATIVE REFERENDUM NO. 371,FOR THE PROPOSAL - YES,220008,8,18,254,280
DEWEY,STATE QUESTION NO. 794 LEGISLATIVE REFERENDUM NO. 371,AGAINST THE PROPOSAL - NO,220008,13,7,64,84
DEWEY,STATE QUESTION NO. 794 LEGISLATIVE REFERENDUM NO. 371,FOR THE PROPOSAL - YES,220009,5,1,98,104
DEWEY,STATE QUESTION NO. 794 LEGISLATIVE REFERENDUM NO. 371,AGAINST THE PROPOSAL - NO,220009,0,2,17,19
DEWEY,STATE QUESTION NO. 794 LEGISLATIVE REFERENDUM NO. 371,FOR THE PROPOSAL - YES,220010,1,0,29,30
DEWEY,STATE QUESTION NO. 794 LEGISLATIVE REFERENDUM NO. 371,AGAINST THE PROPOSAL - NO,220010,0,0,6,6
ELLIS,STATE QUESTION NO. 794 LEGISLATIVE REFERENDUM NO. 371,FOR THE PROPOSAL - YES,230001,17,49,206,272
ELLIS,STATE QUESTION NO. 794 LEGISLATIVE REFERENDUM NO. 371,AGAINST THE PROPOSAL - NO,230001,9,24,73,106
ELLIS,STATE QUESTION NO. 794 LEGISLATIVE REFERENDUM NO. 371,FOR THE PROPOSAL - YES,230003,14,15,320,349
ELLIS,STATE QUESTION NO. 794 LEGISLATIVE REFERENDUM NO. 371,AGAINST THE PROPOSAL - NO,230003,6,3,97,106
ELLIS,STATE QUESTION NO. 794 LEGISLATIVE REFERENDUM NO. 371,FOR THE PROPOSAL - YES,230004,0,5,57,62
ELLIS,STATE QUESTION NO. 794 LEGISLATIVE REFERENDUM NO. 371,AGAINST THE PROPOSAL - NO,230004,0,0,24,24
ELLIS,STATE QUESTION NO. 794 LEGISLATIVE REFERENDUM NO. 371,FOR THE PROPOSAL - YES,230006,8,1,20,29
ELLIS,STATE QUESTION NO. 794 LEGISLATIVE REFERENDUM NO. 371,AGAINST THE PROPOSAL - NO,230006,0,1,14,15
ELLIS,STATE QUESTION NO. 794 LEGISLATIVE REFERENDUM NO. 371,FOR THE PROPOSAL - YES,230007,10,13,157,180
ELLIS,STATE QUESTION NO. 794 LEGISLATIVE REFERENDUM NO. 371,AGAINST THE PROPOSAL - NO,230007,1,3,39,43
ELLIS,STATE QUESTION NO. 794 LEGISLATIVE REFERENDUM NO. 371,FOR THE PROPOSAL - YES,230008,11,9,144,164
ELLIS,STATE QUESTION NO. 794 LEGISLATIVE REFERENDUM NO. 371,AGAINST THE PROPOSAL - NO,230008,2,0,26,28
ELLIS,STATE QUESTION NO. 794 LEGISLATIVE REFERENDUM NO. 371,FOR THE PROPOSAL - YES,230009,3,14,49,66
ELLIS,STATE QUESTION NO. 794 LEGISLATIVE REFERENDUM NO. 371,AGAINST THE PROPOSAL - NO,230009,2,4,13,19
GARFIELD,STATE QUESTION NO. 794 LEGISLATIVE REFERENDUM NO. 371,FOR THE PROPOSAL - YES,240101,15,19,235,269
GARFIELD,STATE QUESTION NO. 794 LEGISLATIVE REFERENDUM NO. 371,AGAINST THE PROPOSAL - NO,240101,4,3,51,58
GARFIELD,STATE QUESTION NO. 794 LEGISLATIVE REFERENDUM NO. 371,FOR THE PROPOSAL - YES,240102,12,29,268,309
GARFIELD,STATE QUESTION NO. 794 LEGISLATIVE REFERENDUM NO. 371,AGAINST THE PROPOSAL - NO,240102,3,8,56,67
GARFIELD,STATE QUESTION NO. 794 LEGISLATIVE REFERENDUM NO. 371,FOR THE PROPOSAL - YES,240103,9,31,404,444
GARFIELD,STATE QUESTION NO. 794 LEGISLATIVE REFERENDUM NO. 371,AGAINST THE PROPOSAL - NO,240103,4,5,92,101
GARFIELD,STATE QUESTION NO. 794 LEGISLATIVE REFERENDUM NO. 371,FOR THE PROPOSAL - YES,240104,20,32,394,446
GARFIELD,STATE QUESTION NO. 794 LEGISLATIVE REFERENDUM NO. 371,AGAINST THE PROPOSAL - NO,240104,7,10,111,128
GARFIELD,STATE QUESTION NO. 794 LEGISLATIVE REFERENDUM NO. 371,FOR THE PROPOSAL - YES,240105,10,35,282,327
GARFIELD,STATE QUESTION NO. 794 LEGISLATIVE REFERENDUM NO. 371,AGAINST THE PROPOSAL - NO,240105,2,9,80,91
GARFIELD,STATE QUESTION NO. 794 LEGISLATIVE REFERENDUM NO. 371,FOR THE PROPOSAL - YES,240106,6,6,227,239
GARFIELD,STATE QUESTION NO. 794 LEGISLATIVE REFERENDUM NO. 371,AGAINST THE PROPOSAL - NO,240106,1,9,101,111
GARFIELD,STATE QUESTION NO. 794 LEGISLATIVE REFERENDUM NO. 371,FOR THE PROPOSAL - YES,240107,4,3,49,56
GARFIELD,STATE QUESTION NO. 794 LEGISLATIVE REFERENDUM NO. 371,AGAINST THE PROPOSAL - NO,240107,0,3,21,24
GARFIELD,STATE QUESTION NO. 794 LEGISLATIVE REFERENDUM NO. 371,FOR THE PROPOSAL - YES,240108,5,3,75,83
GARFIELD,STATE QUESTION NO. 794 LEGISLATIVE REFERENDUM NO. 371,AGAINST THE PROPOSAL - NO,240108,1,1,15,17
GARFIELD,STATE QUESTION NO. 794 LEGISLATIVE REFERENDUM NO. 371,FOR THE PROPOSAL - YES,240109,8,8,148,164
GARFIELD,STATE QUESTION NO. 794 LEGISLATIVE REFERENDUM NO. 371,AGAINST THE PROPOSAL - NO,240109,2,1,65,68
GARFIELD,STATE QUESTION NO. 794 LEGISLATIVE REFERENDUM NO. 371,FOR THE PROPOSAL - YES,240110,19,60,354,433
GARFIELD,STATE QUESTION NO. 794 LEGISLATIVE REFERENDUM NO. 371,AGAINST THE PROPOSAL - NO,240110,3,23,82,108
GARFIELD,STATE QUESTION NO. 794 LEGISLATIVE REFERENDUM NO. 371,FOR THE PROPOSAL - YES,240201,42,110,617,769
GARFIELD,STATE QUESTION NO. 794 LEGISLATIVE REFERENDUM NO. 371,AGAINST THE PROPOSAL - NO,240201,16,70,219,305
GARFIELD,STATE QUESTION NO. 794 LEGISLATIVE REFERENDUM NO. 371,FOR THE PROPOSAL - YES,240202,58,101,605,764
GARFIELD,STATE QUESTION NO. 794 LEGISLATIVE REFERENDUM NO. 371,AGAINST THE PROPOSAL - NO,240202,12,31,200,243
GARFIELD,STATE QUESTION NO. 794 LEGISLATIVE REFERENDUM NO. 371,FOR THE PROPOSAL - YES,240203,16,36,301,353
GARFIELD,STATE QUESTION NO. 794 LEGISLATIVE REFERENDUM NO. 371,AGAINST THE PROPOSAL - NO,240203,2,2,82,86
GARFIELD,STATE QUESTION NO. 794 LEGISLATIVE REFERENDUM NO. 371,FOR THE PROPOSAL - YES,240204,36,117,779,932
GARFIELD,STATE QUESTION NO. 794 LEGISLATIVE REFERENDUM NO. 371,AGAINST THE PROPOSAL - NO,240204,10,47,255,312
GARFIELD,STATE QUESTION NO. 794 LEGISLATIVE REFERENDUM NO. 371,FOR THE PROPOSAL - YES,240206,8,35,422,465
GARFIELD,STATE QUESTION NO. 794 LEGISLATIVE REFERENDUM NO. 371,AGAINST THE PROPOSAL - NO,240206,5,10,122,137
GARFIELD,STATE QUESTION NO. 794 LEGISLATIVE REFERENDUM NO. 371,FOR THE PROPOSAL - YES,240207,16,28,398,442
GARFIELD,STATE QUESTION NO. 794 LEGISLATIVE REFERENDUM NO. 371,AGAINST THE PROPOSAL - NO,240207,5,5,116,126
GARFIELD,STATE QUESTION NO. 794 LEGISLATIVE REFERENDUM NO. 371,FOR THE PROPOSAL - YES,240208,1,4,74,79
GARFIELD,STATE QUESTION NO. 794 LEGISLATIVE REFERENDUM NO. 371,AGAINST THE PROPOSAL - NO,240208,1,3,27,31
GARFIELD,STATE QUESTION NO. 794 LEGISLATIVE REFERENDUM NO. 371,FOR THE PROPOSAL - YES,240210,2,5,221,228
GARFIELD,STATE QUESTION NO. 794 LEGISLATIVE REFERENDUM NO. 371,AGAINST THE PROPOSAL - NO,240210,0,3,69,72
GARFIELD,STATE QUESTION NO. 794 LEGISLATIVE REFERENDUM NO. 371,FOR THE PROPOSAL - YES,240211,13,36,337,386
GARFIELD,STATE QUESTION NO. 794 LEGISLATIVE REFERENDUM NO. 371,AGAINST THE PROPOSAL - NO,240211,7,7,114,128
GARFIELD,STATE QUESTION NO. 794 LEGISLATIVE REFERENDUM NO. 371,FOR THE PROPOSAL - YES,240212,11,9,234,254
GARFIELD,STATE QUESTION NO. 794 LEGISLATIVE REFERENDUM NO. 371,AGAINST THE PROPOSAL - NO,240212,3,3,58,64
GARFIELD,STATE QUESTION NO. 794 LEGISLATIVE REFERENDUM NO. 371,FOR THE PROPOSAL - YES,240301,18,52,335,405
GARFIELD,STATE QUESTION NO. 794 LEGISLATIVE REFERENDUM NO. 371,AGAINST THE PROPOSAL - NO,240301,0,17,91,108
GARFIELD,STATE QUESTION NO. 794 LEGISLATIVE REFERENDUM NO. 371,FOR THE PROPOSAL - YES,240302,52,163,888,1103
GARFIELD,STATE QUESTION NO. 794 LEGISLATIVE REFERENDUM NO. 371,AGAINST THE PROPOSAL - NO,240302,16,47,247,310
GARFIELD,STATE QUESTION NO. 794 LEGISLATIVE REFERENDUM NO. 371,FOR THE PROPOSAL - YES,240304,58,151,733,942
GARFIELD,STATE QUESTION NO. 794 LEGISLATIVE REFERENDUM NO. 371,AGAINST THE PROPOSAL - NO,240304,21,55,240,316
GARFIELD,STATE QUESTION NO. 794 LEGISLATIVE REFERENDUM NO. 371,FOR THE PROPOSAL - YES,240305,43,149,633,825
GARFIELD,STATE QUESTION NO. 794 LEGISLATIVE REFERENDUM NO. 371,AGAINST THE PROPOSAL - NO,240305,16,57,210,283
GARFIELD,STATE QUESTION NO. 794 LEGISLATIVE REFERENDUM NO. 371,FOR THE PROPOSAL - YES,240306,24,55,342,421
GARFIELD,STATE QUESTION NO. 794 LEGISLATIVE REFERENDUM NO. 371,AGAINST THE PROPOSAL - NO,240306,2,21,108,131
GARFIELD,STATE QUESTION NO. 794 LEGISLATIVE REFERENDUM NO. 371,FOR THE PROPOSAL - YES,240307,15,17,165,197
GARFIELD,STATE QUESTION NO. 794 LEGISLATIVE REFERENDUM NO. 371,AGAINST THE PROPOSAL - NO,240307,8,2,40,50
GARFIELD,STATE QUESTION NO. 794 LEGISLATIVE REFERENDUM NO. 371,FOR THE PROPOSAL - YES,240308,37,55,358,450
GARFIELD,STATE QUESTION NO. 794 LEGISLATIVE REFERENDUM NO. 371,AGAINST THE PROPOSAL - NO,240308,11,25,113,149
GARFIELD,STATE QUESTION NO. 794 LEGISLATIVE REFERENDUM NO. 371,FOR THE PROPOSAL - YES,240309,7,22,301,330
GARFIELD,STATE QUESTION NO. 794 LEGISLATIVE REFERENDUM NO. 371,AGAINST THE PROPOSAL - NO,240309,3,9,86,98
GARFIELD,STATE QUESTION NO. 794 LEGISLATIVE REFERENDUM NO. 371,FOR THE PROPOSAL - YES,240310,21,32,337,390
GARFIELD,STATE QUESTION NO. 794 LEGISLATIVE REFERENDUM NO. 371,AGAINST THE PROPOSAL - NO,240310,3,13,97,113
GARFIELD,STATE QUESTION NO. 794 LEGISLATIVE REFERENDUM NO. 371,FOR THE PROPOSAL - YES,240311,20,63,510,593
GARFIELD,STATE QUESTION NO. 794 LEGISLATIVE REFERENDUM NO. 371,AGAINST THE PROPOSAL - NO,240311,9,32,164,205
GARVIN,STATE QUESTION NO. 794 LEGISLATIVE REFERENDUM NO. 371,FOR THE PROPOSAL - YES,250001,9,6,258,273
GARVIN,STATE QUESTION NO. 794 LEGISLATIVE REFERENDUM NO. 371,AGAINST THE PROPOSAL - NO,250001,5,3,88,96
GARVIN,STATE QUESTION NO. 794 LEGISLATIVE REFERENDUM NO. 371,FOR THE PROPOSAL - YES,250002,9,13,341,363
GARVIN,STATE QUESTION NO. 794 LEGISLATIVE REFERENDUM NO. 371,AGAINST THE PROPOSAL - NO,250002,3,3,91,97
GARVIN,STATE QUESTION NO. 794 LEGISLATIVE REFERENDUM NO. 371,FOR THE PROPOSAL - YES,250003,5,6,409,420
GARVIN,STATE QUESTION NO. 794 LEGISLATIVE REFERENDUM NO. 371,AGAINST THE PROPOSAL - NO,250003,5,5,93,103
GARVIN,STATE QUESTION NO. 794 LEGISLATIVE REFERENDUM NO. 371,FOR THE PROPOSAL - YES,250005,20,29,462,511
GARVIN,STATE QUESTION NO. 794 LEGISLATIVE REFERENDUM NO. 371,AGAINST THE PROPOSAL - NO,250005,6,6,118,130
GARVIN,STATE QUESTION NO. 794 LEGISLATIVE REFERENDUM NO. 371,FOR THE PROPOSAL - YES,250006,3,11,198,212
GARVIN,STATE QUESTION NO. 794 LEGISLATIVE REFERENDUM NO. 371,AGAINST THE PROPOSAL - NO,250006,2,5,70,77
GARVIN,STATE QUESTION NO. 794 LEGISLATIVE REFERENDUM NO. 371,FOR THE PROPOSAL - YES,250007,6,65,219,290
GARVIN,STATE QUESTION NO. 794 LEGISLATIVE REFERENDUM NO. 371,AGAINST THE PROPOSAL - NO,250007,6,15,77,98
GARVIN,STATE QUESTION NO. 794 LEGISLATIVE REFERENDUM NO. 371,FOR THE PROPOSAL - YES,250008,13,61,256,330
GARVIN,STATE QUESTION NO. 794 LEGISLATIVE REFERENDUM NO. 371,AGAINST THE PROPOSAL - NO,250008,1,11,59,71
GARVIN,STATE QUESTION NO. 794 LEGISLATIVE REFERENDUM NO. 371,FOR THE PROPOSAL - YES,250009,9,44,469,522
GARVIN,STATE QUESTION NO. 794 LEGISLATIVE REFERENDUM NO. 371,AGAINST THE PROPOSAL - NO,250009,2,10,94,106
GARVIN,STATE QUESTION NO. 794 LEGISLATIVE REFERENDUM NO. 371,FOR THE PROPOSAL - YES,250013,4,10,180,194
GARVIN,STATE QUESTION NO. 794 LEGISLATIVE REFERENDUM NO. 371,AGAINST THE PROPOSAL - NO,250013,3,5,42,50
GARVIN,STATE QUESTION NO. 794 LEGISLATIVE REFERENDUM NO. 371,FOR THE PROPOSAL - YES,250015,10,66,308,384
GARVIN,STATE QUESTION NO. 794 LEGISLATIVE REFERENDUM NO. 371,AGAINST THE PROPOSAL - NO,250015,3,16,69,88
GARVIN,STATE QUESTION NO. 794 LEGISLATIVE REFERENDUM NO. 371,FOR THE PROPOSAL - YES,250016,13,46,326,385
GARVIN,STATE QUESTION NO. 794 LEGISLATIVE REFERENDUM NO. 371,AGAINST THE PROPOSAL - NO,250016,3,14,53,70
GARVIN,STATE QUESTION NO. 794 LEGISLATIVE REFERENDUM NO. 371,FOR THE PROPOSAL - YES,250017,7,44,264,315
GARVIN,STATE QUESTION NO. 794 LEGISLATIVE REFERENDUM NO. 371,AGAINST THE PROPOSAL - NO,250017,1,8,59,68
GARVIN,STATE QUESTION NO. 794 LEGISLATIVE REFERENDUM NO. 371,FOR THE PROPOSAL - YES,250018,24,137,529,690
GARVIN,STATE QUESTION NO. 794 LEGISLATIVE REFERENDUM NO. 371,AGAINST THE PROPOSAL - NO,250018,6,33,131,170
GARVIN,STATE QUESTION NO. 794 LEGISLATIVE REFERENDUM NO. 371,FOR THE PROPOSAL - YES,250020,11,34,537,582
GARVIN,STATE QUESTION NO. 794 LEGISLATIVE REFERENDUM NO. 371,AGAINST THE PROPOSAL - NO,250020,2,4,96,102
GARVIN,STATE QUESTION NO. 794 LEGISLATIVE REFERENDUM NO. 371,FOR THE PROPOSAL - YES,250021,1,0,11,12
GARVIN,STATE QUESTION NO. 794 LEGISLATIVE REFERENDUM NO. 371,AGAINST THE PROPOSAL - NO,250021,0,0,2,2
GARVIN,STATE QUESTION NO. 794 LEGISLATIVE REFERENDUM NO. 371,FOR THE PROPOSAL - YES,250024,7,25,409,441
GARVIN,STATE QUESTION NO. 794 LEGISLATIVE REFERENDUM NO. 371,AGAINST THE PROPOSAL - NO,250024,1,6,107,114
GARVIN,STATE QUESTION NO. 794 LEGISLATIVE REFERENDUM NO. 371,FOR THE PROPOSAL - YES,250025,16,35,282,333
GARVIN,STATE QUESTION NO. 794 LEGISLATIVE REFERENDUM NO. 371,AGAINST THE PROPOSAL - NO,250025,5,3,78,86
GRADY,STATE QUESTION NO. 794 LEGISLATIVE REFERENDUM NO. 371,FOR THE PROPOSAL - YES,260001,13,34,366,413
GRADY,STATE QUESTION NO. 794 LEGISLATIVE REFERENDUM NO. 371,AGAINST THE PROPOSAL - NO,260001,7,10,73,90
GRADY,STATE QUESTION NO. 794 LEGISLATIVE REFERENDUM NO. 371,FOR THE PROPOSAL - YES,260002,28,61,471,560
GRADY,STATE QUESTION NO. 794 LEGISLATIVE REFERENDUM NO. 371,AGAINST THE PROPOSAL - NO,260002,5,13,112,130
GRADY,STATE QUESTION NO. 794 LEGISLATIVE REFERENDUM NO. 371,FOR THE PROPOSAL - YES,260003,23,52,429,504
GRADY,STATE QUESTION NO. 794 LEGISLATIVE REFERENDUM NO. 371,AGAINST THE PROPOSAL - NO,260003,6,15,103,124
GRADY,STATE QUESTION NO. 794 LEGISLATIVE REFERENDUM NO. 371,FOR THE PROPOSAL - YES,260005,13,41,236,290
GRADY,STATE QUESTION NO. 794 LEGISLATIVE REFERENDUM NO. 371,AGAINST THE PROPOSAL - NO,260005,1,10,65,76
GRADY,STATE QUESTION NO. 794 LEGISLATIVE REFERENDUM NO. 371,FOR THE PROPOSAL - YES,260006,27,54,338,419
GRADY,STATE QUESTION NO. 794 LEGISLATIVE REFERENDUM NO. 371,AGAINST THE PROPOSAL - NO,260006,8,13,70,91
GRADY,STATE QUESTION NO. 794 LEGISLATIVE REFERENDUM NO. 371,FOR THE PROPOSAL - YES,260008,11,40,318,369
GRADY,STATE QUESTION NO. 794 LEGISLATIVE REFERENDUM NO. 371,AGAINST THE PROPOSAL - NO,260008,4,8,88,100
GRADY,STATE QUESTION NO. 794 LEGISLATIVE REFERENDUM NO. 371,FOR THE PROPOSAL - YES,260009,25,58,453,536
GRADY,STATE QUESTION NO. 794 LEGISLATIVE REFERENDUM NO. 371,AGAINST THE PROPOSAL - NO,260009,8,29,128,165
GRADY,STATE QUESTION NO. 794 LEGISLATIVE REFERENDUM NO. 371,FOR THE PROPOSAL - YES,260011,15,30,199,244
GRADY,STATE QUESTION NO. 794 LEGISLATIVE REFERENDUM NO. 371,AGAINST THE PROPOSAL - NO,260011,3,5,50,58
GRADY,STATE QUESTION NO. 794 LEGISLATIVE REFERENDUM NO. 371,FOR THE PROPOSAL - YES,260016,7,0,74,81
GRADY,STATE QUESTION NO. 794 LEGISLATIVE REFERENDUM NO. 371,AGAINST THE PROPOSAL - NO,260016,1,1,28,30
GRADY,STATE QUESTION NO. 794 LEGISLATIVE REFERENDUM NO. 371,FOR THE PROPOSAL - YES,260017,1,4,148,153
GRADY,STATE QUESTION NO. 794 LEGISLATIVE REFERENDUM NO. 371,AGAINST THE PROPOSAL - NO,260017,0,4,43,47
GRADY,STATE QUESTION NO. 794 LEGISLATIVE REFERENDUM NO. 371,FOR THE PROPOSAL - YES,260020,10,24,163,197
GRADY,STATE QUESTION NO. 794 LEGISLATIVE REFERENDUM NO. 371,AGAINST THE PROPOSAL - NO,260020,3,4,45,52
GRADY,STATE QUESTION NO. 794 LEGISLATIVE REFERENDUM NO. 371,FOR THE PROPOSAL - YES,260021,6,8,156,170
GRADY,STATE QUESTION NO. 794 LEGISLATIVE REFERENDUM NO. 371,AGAINST THE PROPOSAL - NO,260021,1,5,33,39
GRADY,STATE QUESTION NO. 794 LEGISLATIVE REFERENDUM NO. 371,FOR THE PROPOSAL - YES,260023,4,7,85,96
GRADY,STATE QUESTION NO. 794 LEGISLATIVE REFERENDUM NO. 371,AGAINST THE PROPOSAL - NO,260023,2,0,16,18
GRADY,STATE QUESTION NO. 794 LEGISLATIVE REFERENDUM NO. 371,FOR THE PROPOSAL - YES,260025,11,38,252,301
GRADY,STATE QUESTION NO. 794 LEGISLATIVE REFERENDUM NO. 371,AGAINST THE PROPOSAL - NO,260025,3,4,70,77
GRADY,STATE QUESTION NO. 794 LEGISLATIVE REFERENDUM NO. 371,FOR THE PROPOSAL - YES,260026,10,16,94,120
GRADY,STATE QUESTION NO. 794 LEGISLATIVE REFERENDUM NO. 371,AGAINST THE PROPOSAL - NO,260026,3,3,26,32
GRADY,STATE QUESTION NO. 794 LEGISLATIVE REFERENDUM NO. 371,FOR THE PROPOSAL - YES,260027,7,32,198,237
GRADY,STATE QUESTION NO. 794 LEGISLATIVE REFERENDUM NO. 371,AGAINST THE PROPOSAL - NO,260027,4,15,45,64
GRADY,STATE QUESTION NO. 794 LEGISLATIVE REFERENDUM NO. 371,FOR THE PROPOSAL - YES,260028,25,29,546,600
GRADY,STATE QUESTION NO. 794 LEGISLATIVE REFERENDUM NO. 371,AGAINST THE PROPOSAL - NO,260028,9,8,129,146
GRADY,STATE QUESTION NO. 794 LEGISLATIVE REFERENDUM NO. 371,FOR THE PROPOSAL - YES,260029,30,17,713,760
GRADY,STATE QUESTION NO. 794 LEGISLATIVE REFERENDUM NO. 371,AGAINST THE PROPOSAL - NO,260029,8,4,151,163
GRADY,STATE QUESTION NO. 794 LEGISLATIVE REFERENDUM NO. 371,FOR THE PROPOSAL - YES,260031,6,18,280,304
GRADY,STATE QUESTION NO. 794 LEGISLATIVE REFERENDUM NO. 371,AGAINST THE PROPOSAL - NO,260031,8,0,73,81
GRADY,STATE QUESTION NO. 794 LEGISLATIVE REFERENDUM NO. 371,FOR THE PROPOSAL - YES,260032,23,67,467,557
GRADY,STATE QUESTION NO. 794 LEGISLATIVE REFERENDUM NO. 371,AGAINST THE PROPOSAL - NO,260032,8,19,88,115
GRADY,STATE QUESTION NO. 794 LEGISLATIVE REFERENDUM NO. 371,FOR THE PROPOSAL - YES,260033,5,12,139,156
GRADY,STATE QUESTION NO. 794 LEGISLATIVE REFERENDUM NO. 371,AGAINST THE PROPOSAL - NO,260033,2,3,30,35
GRADY,STATE QUESTION NO. 794 LEGISLATIVE REFERENDUM NO. 371,FOR THE PROPOSAL - YES,260035,0,5,89,94
GRADY,STATE QUESTION NO. 794 LEGISLATIVE REFERENDUM NO. 371,AGAINST THE PROPOSAL - NO,260035,0,2,24,26
GRADY,STATE QUESTION NO. 794 LEGISLATIVE REFERENDUM NO. 371,FOR THE PROPOSAL - YES,260036,32,23,682,737
GRADY,STATE QUESTION NO. 794 LEGISLATIVE REFERENDUM NO. 371,AGAINST THE PROPOSAL - NO,260036,14,3,198,215
GRADY,STATE QUESTION NO. 794 LEGISLATIVE REFERENDUM NO. 371,FOR THE PROPOSAL - YES,260037,138,62,1226,1426
GRADY,STATE QUESTION NO. 794 LEGISLATIVE REFERENDUM NO. 371,AGAINST THE PROPOSAL - NO,260037,40,10,269,319
GRADY,STATE QUESTION NO. 794 LEGISLATIVE REFERENDUM NO. 371,FOR THE PROPOSAL - YES,260038,88,37,995,1120
GRADY,STATE QUESTION NO. 794 LEGISLATIVE REFERENDUM NO. 371,AGAINST THE PROPOSAL - NO,260038,16,8,236,260
GRADY,STATE QUESTION NO. 794 LEGISLATIVE REFERENDUM NO. 371,FOR THE PROPOSAL - YES,260039,45,32,701,778
GRADY,STATE QUESTION NO. 794 LEGISLATIVE REFERENDUM NO. 371,AGAINST THE PROPOSAL - NO,260039,11,5,184,200
GRADY,STATE QUESTION NO. 794 LEGISLATIVE REFERENDUM NO. 371,FOR THE PROPOSAL - YES,260040,91,39,1005,1135
GRADY,STATE QUESTION NO. 794 LEGISLATIVE REFERENDUM NO. 371,AGAINST THE PROPOSAL - NO,260040,14,9,261,284
GRADY,STATE QUESTION NO. 794 LEGISLATIVE REFERENDUM NO. 371,FOR THE PROPOSAL - YES,260041,84,53,1041,1178
GRADY,STATE QUESTION NO. 794 LEGISLATIVE REFERENDUM NO. 371,AGAINST THE PROPOSAL - NO,260041,29,4,280,313
GRANT,STATE QUESTION NO. 794 LEGISLATIVE REFERENDUM NO. 371,FOR THE PROPOSAL - YES,270011,1,1,65,67
GRANT,STATE QUESTION NO. 794 LEGISLATIVE REFERENDUM NO. 371,AGAINST THE PROPOSAL - NO,270011,1,0,25,26
GRANT,STATE QUESTION NO. 794 LEGISLATIVE REFERENDUM NO. 371,FOR THE PROPOSAL - YES,270017,8,11,184,203
GRANT,STATE QUESTION NO. 794 LEGISLATIVE REFERENDUM NO. 371,AGAINST THE PROPOSAL - NO,270017,3,3,41,47
GRANT,STATE QUESTION NO. 794 LEGISLATIVE REFERENDUM NO. 371,FOR THE PROPOSAL - YES,270023,8,18,297,323
GRANT,STATE QUESTION NO. 794 LEGISLATIVE REFERENDUM NO. 371,AGAINST THE PROPOSAL - NO,270023,1,2,89,92
GRANT,STATE QUESTION NO. 794 LEGISLATIVE REFERENDUM NO. 371,FOR THE PROPOSAL - YES,270025,6,15,163,184
GRANT,STATE QUESTION NO. 794 LEGISLATIVE REFERENDUM NO. 371,AGAINST THE PROPOSAL - NO,270025,4,4,47,55
GRANT,STATE QUESTION NO. 794 LEGISLATIVE REFERENDUM NO. 371,FOR THE PROPOSAL - YES,270026,2,6,153,161
GRANT,STATE QUESTION NO. 794 LEGISLATIVE REFERENDUM NO. 371,AGAINST THE PROPOSAL - NO,270026,0,3,39,42
GRANT,STATE QUESTION NO. 794 LEGISLATIVE REFERENDUM NO. 371,FOR THE PROPOSAL - YES,270029,6,15,114,135
GRANT,STATE QUESTION NO. 794 LEGISLATIVE REFERENDUM NO. 371,AGAINST THE PROPOSAL - NO,270029,0,6,25,31
GRANT,STATE QUESTION NO. 794 LEGISLATIVE REFERENDUM NO. 371,FOR THE PROPOSAL - YES,270030,9,22,199,230
GRANT,STATE QUESTION NO. 794 LEGISLATIVE REFERENDUM NO. 371,AGAINST THE PROPOSAL - NO,270030,0,13,76,89
GREER,STATE QUESTION NO. 794 LEGISLATIVE REFERENDUM NO. 371,FOR THE PROPOSAL - YES,280101,5,33,178,216
GREER,STATE QUESTION NO. 794 LEGISLATIVE REFERENDUM NO. 371,AGAINST THE PROPOSAL - NO,280101,6,14,90,110
GREER,STATE QUESTION NO. 794 LEGISLATIVE REFERENDUM NO. 371,FOR THE PROPOSAL - YES,280102,15,36,253,304
GREER,STATE QUESTION NO. 794 LEGISLATIVE REFERENDUM NO. 371,AGAINST THE PROPOSAL - NO,280102,0,13,103,116
GREER,STATE QUESTION NO. 794 LEGISLATIVE REFERENDUM NO. 371,FOR THE PROPOSAL - YES,280103,1,2,12,15
GREER,STATE QUESTION NO. 794 LEGISLATIVE REFERENDUM NO. 371,AGAINST THE PROPOSAL - NO,280103,0,1,4,5
GREER,STATE QUESTION NO. 794 LEGISLATIVE REFERENDUM NO. 371,FOR THE PROPOSAL - YES,280105,2,8,35,45
GREER,STATE QUESTION NO. 794 LEGISLATIVE REFERENDUM NO. 371,AGAINST THE PROPOSAL - NO,280105,0,2,28,30
GREER,STATE QUESTION NO. 794 LEGISLATIVE REFERENDUM NO. 371,FOR THE PROPOSAL - YES,280106,2,7,36,45
GREER,STATE QUESTION NO. 794 LEGISLATIVE REFERENDUM NO. 371,AGAINST THE PROPOSAL - NO,280106,0,2,28,30
GREER,STATE QUESTION NO. 794 LEGISLATIVE REFERENDUM NO. 371,FOR THE PROPOSAL - YES,280202,3,11,197,211
GREER,STATE QUESTION NO. 794 LEGISLATIVE REFERENDUM NO. 371,AGAINST THE PROPOSAL - NO,280202,4,2,120,126
GREER,STATE QUESTION NO. 794 LEGISLATIVE REFERENDUM NO. 371,FOR THE PROPOSAL - YES,280203,6,8,85,99
GREER,STATE QUESTION NO. 794 LEGISLATIVE REFERENDUM NO. 371,AGAINST THE PROPOSAL - NO,280203,1,1,31,33
GREER,STATE QUESTION NO. 794 LEGISLATIVE REFERENDUM NO. 371,FOR THE PROPOSAL - YES,280302,1,2,23,26
GREER,STATE QUESTION NO. 794 LEGISLATIVE REFERENDUM NO. 371,AGAINST THE PROPOSAL - NO,280302,0,2,14,16
HARMON,STATE QUESTION NO. 794 LEGISLATIVE REFERENDUM NO. 371,FOR THE PROPOSAL - YES,290101,0,4,29,33
HARMON,STATE QUESTION NO. 794 LEGISLATIVE REFERENDUM NO. 371,AGAINST THE PROPOSAL - NO,290101,0,3,5,8
HARMON,STATE QUESTION NO. 794 LEGISLATIVE REFERENDUM NO. 371,FOR THE PROPOSAL - YES,290102,5,19,154,178
HARMON,STATE QUESTION NO. 794 LEGISLATIVE REFERENDUM NO. 371,AGAINST THE PROPOSAL - NO,290102,0,5,60,65
HARMON,STATE QUESTION NO. 794 LEGISLATIVE REFERENDUM NO. 371,FOR THE PROPOSAL - YES,290201,3,21,104,128
HARMON,STATE QUESTION NO. 794 LEGISLATIVE REFERENDUM NO. 371,AGAINST THE PROPOSAL - NO,290201,0,5,40,45
HARMON,STATE QUESTION NO. 794 LEGISLATIVE REFERENDUM NO. 371,FOR THE PROPOSAL - YES,290203,1,4,10,15
HARMON,STATE QUESTION NO. 794 LEGISLATIVE REFERENDUM NO. 371,AGAINST THE PROPOSAL - NO,290203,0,1,4,5
HARMON,STATE QUESTION NO. 794 LEGISLATIVE REFERENDUM NO. 371,FOR THE PROPOSAL - YES,290204,0,1,12,13
HARMON,STATE QUESTION NO. 794 LEGISLATIVE REFERENDUM NO. 371,AGAINST THE PROPOSAL - NO,290204,0,1,2,3
HARMON,STATE QUESTION NO. 794 LEGISLATIVE REFERENDUM NO. 371,FOR THE PROPOSAL - YES,290301,3,15,77,95
HARMON,STATE QUESTION NO. 794 LEGISLATIVE REFERENDUM NO. 371,AGAINST THE PROPOSAL - NO,290301,1,3,17,21
HARMON,STATE QUESTION NO. 794 LEGISLATIVE REFERENDUM NO. 371,FOR THE PROPOSAL - YES,290302,0,1,86,87
HARMON,STATE QUESTION NO. 794 LEGISLATIVE REFERENDUM NO. 371,AGAINST THE PROPOSAL - NO,290302,3,3,16,22
HARPER,STATE QUESTION NO. 794 LEGISLATIVE REFERENDUM NO. 371,FOR THE PROPOSAL - YES,300201,12,9,293,314
HARPER,STATE QUESTION NO. 794 LEGISLATIVE REFERENDUM NO. 371,AGAINST THE PROPOSAL - NO,300201,1,8,132,141
HARPER,STATE QUESTION NO. 794 LEGISLATIVE REFERENDUM NO. 371,FOR THE PROPOSAL - YES,300203,4,3,57,64
HARPER,STATE QUESTION NO. 794 LEGISLATIVE REFERENDUM NO. 371,AGAINST THE PROPOSAL - NO,300203,2,1,26,29
HARPER,STATE QUESTION NO. 794 LEGISLATIVE REFERENDUM NO. 371,FOR THE PROPOSAL - YES,300301,3,22,147,172
HARPER,STATE QUESTION NO. 794 LEGISLATIVE REFERENDUM NO. 371,AGAINST THE PROPOSAL - NO,300301,3,6,42,51
HARPER,STATE QUESTION NO. 794 LEGISLATIVE REFERENDUM NO. 371,FOR THE PROPOSAL - YES,300302,3,5,25,33
HARPER,STATE QUESTION NO. 794 LEGISLATIVE REFERENDUM NO. 371,AGAINST THE PROPOSAL - NO,300302,0,0,17,17
HARPER,STATE QUESTION NO. 794 LEGISLATIVE REFERENDUM NO. 371,FOR THE PROPOSAL - YES,300303,1,15,72,88
HARPER,STATE QUESTION NO. 794 LEGISLATIVE REFERENDUM NO. 371,AGAINST THE PROPOSAL - NO,300303,1,1,17,19
HARPER,STATE QUESTION NO. 794 LEGISLATIVE REFERENDUM NO. 371,FOR THE PROPOSAL - YES,300402,11,34,167,212
HARPER,STATE QUESTION NO. 794 LEGISLATIVE REFERENDUM NO. 371,AGAINST THE PROPOSAL - NO,300402,1,5,55,61
HASKELL,STATE QUESTION NO. 794 LEGISLATIVE REFERENDUM NO. 371,FOR THE PROPOSAL - YES,310007,6,10,128,144
HASKELL,STATE QUESTION NO. 794 LEGISLATIVE REFERENDUM NO. 371,AGAINST THE PROPOSAL - NO,310007,0,3,50,53
HASKELL,STATE QUESTION NO. 794 LEGISLATIVE REFERENDUM NO. 371,FOR THE PROPOSAL - YES,310009,3,4,47,54
HASKELL,STATE QUESTION NO. 794 LEGISLATIVE REFERENDUM NO. 371,AGAINST THE PROPOSAL - NO,310009,0,2,20,22
HASKELL,STATE QUESTION NO. 794 LEGISLATIVE REFERENDUM NO. 371,FOR THE PROPOSAL - YES,310011,3,6,81,90
HASKELL,STATE QUESTION NO. 794 LEGISLATIVE REFERENDUM NO. 371,AGAINST THE PROPOSAL - NO,310011,1,3,18,22
HASKELL,STATE QUESTION NO. 794 LEGISLATIVE REFERENDUM NO. 371,FOR THE PROPOSAL - YES,310015,2,32,162,196
HASKELL,STATE QUESTION NO. 794 LEGISLATIVE REFERENDUM NO. 371,AGAINST THE PROPOSAL - NO,310015,1,8,56,65
HASKELL,STATE QUESTION NO. 794 LEGISLATIVE REFERENDUM NO. 371,FOR THE PROPOSAL - YES,310016,9,59,194,262
HASKELL,STATE QUESTION NO. 794 LEGISLATIVE REFERENDUM NO. 371,AGAINST THE PROPOSAL - NO,310016,1,12,53,66
HASKELL,STATE QUESTION NO. 794 LEGISLATIVE REFERENDUM NO. 371,FOR THE PROPOSAL - YES,310019,2,36,277,315
HASKELL,STATE QUESTION NO. 794 LEGISLATIVE REFERENDUM NO. 371,AGAINST THE PROPOSAL - NO,310019,4,4,84,92
HASKELL,STATE QUESTION NO. 794 LEGISLATIVE REFERENDUM NO. 371,FOR THE PROPOSAL - YES,310023,13,26,321,360
HASKELL,STATE QUESTION NO. 794 LEGISLATIVE REFERENDUM NO. 371,AGAINST THE PROPOSAL - NO,310023,5,4,110,119
HASKELL,STATE QUESTION NO. 794 LEGISLATIVE REFERENDUM NO. 371,FOR THE PROPOSAL - YES,310027,6,70,272,348
HASKELL,STATE QUESTION NO. 794 LEGISLATIVE REFERENDUM NO. 371,AGAINST THE PROPOSAL - NO,310027,5,22,98,125
HASKELL,STATE QUESTION NO. 794 LEGISLATIVE REFERENDUM NO. 371,FOR THE PROPOSAL - YES,310030,7,41,200,248
HASKELL,STATE QUESTION NO. 794 LEGISLATIVE REFERENDUM NO. 371,AGAINST THE PROPOSAL - NO,310030,3,7,58,68
HASKELL,STATE QUESTION NO. 794 LEGISLATIVE REFERENDUM NO. 371,FOR THE PROPOSAL - YES,310031,21,31,362,414
HASKELL,STATE QUESTION NO. 794 LEGISLATIVE REFERENDUM NO. 371,AGAINST THE PROPOSAL - NO,310031,3,9,114,126
HASKELL,STATE QUESTION NO. 794 LEGISLATIVE REFERENDUM NO. 371,FOR THE PROPOSAL - YES,310032,1,41,251,293
HASKELL,STATE QUESTION NO. 794 LEGISLATIVE REFERENDUM NO. 371,AGAINST THE PROPOSAL - NO,310032,1,6,72,79
HUGHES,STATE QUESTION NO. 794 LEGISLATIVE REFERENDUM NO. 371,FOR THE PROPOSAL - YES,320010,0,0,0,0
HUGHES,STATE QUESTION NO. 794 LEGISLATIVE REFERENDUM NO. 371,AGAINST THE PROPOSAL - NO,320010,0,0,0,0
HUGHES,STATE QUESTION NO. 794 LEGISLATIVE REFERENDUM NO. 371,FOR THE PROPOSAL - YES,320011,13,41,314,368
HUGHES,STATE QUESTION NO. 794 LEGISLATIVE REFERENDUM NO. 371,AGAINST THE PROPOSAL - NO,320011,7,23,66,96
HUGHES,STATE QUESTION NO. 794 LEGISLATIVE REFERENDUM NO. 371,FOR THE PROPOSAL - YES,320012,4,43,186,233
HUGHES,STATE QUESTION NO. 794 LEGISLATIVE REFERENDUM NO. 371,AGAINST THE PROPOSAL - NO,320012,2,4,51,57
HUGHES,STATE QUESTION NO. 794 LEGISLATIVE REFERENDUM NO. 371,FOR THE PROPOSAL - YES,320016,6,16,93,115
HUGHES,STATE QUESTION NO. 794 LEGISLATIVE REFERENDUM NO. 371,AGAINST THE PROPOSAL - NO,320016,1,1,17,19
HUGHES,STATE QUESTION NO. 794 LEGISLATIVE REFERENDUM NO. 371,FOR THE PROPOSAL - YES,320018,2,18,134,154
HUGHES,STATE QUESTION NO. 794 LEGISLATIVE REFERENDUM NO. 371,AGAINST THE PROPOSAL - NO,320018,0,6,39,45
HUGHES,STATE QUESTION NO. 794 LEGISLATIVE REFERENDUM NO. 371,FOR THE PROPOSAL - YES,320019,8,10,62,80
HUGHES,STATE QUESTION NO. 794 LEGISLATIVE REFERENDUM NO. 371,AGAINST THE PROPOSAL - NO,320019,0,1,12,13
HUGHES,STATE QUESTION NO. 794 LEGISLATIVE REFERENDUM NO. 371,FOR THE PROPOSAL - YES,320020,16,31,424,471
HUGHES,STATE QUESTION NO. 794 LEGISLATIVE REFERENDUM NO. 371,AGAINST THE PROPOSAL - NO,320020,4,6,101,111
HUGHES,STATE QUESTION NO. 794 LEGISLATIVE REFERENDUM NO. 371,FOR THE PROPOSAL - YES,320021,4,22,159,185
HUGHES,STATE QUESTION NO. 794 LEGISLATIVE REFERENDUM NO. 371,AGAINST THE PROPOSAL - NO,320021,2,2,35,39
HUGHES,STATE QUESTION NO. 794 LEGISLATIVE REFERENDUM NO. 371,FOR THE PROPOSAL - YES,320022,9,3,156,168
HUGHES,STATE QUESTION NO. 794 LEGISLATIVE REFERENDUM NO. 371,AGAINST THE PROPOSAL - NO,320022,1,2,35,38
HUGHES,STATE QUESTION NO. 794 LEGISLATIVE REFERENDUM NO. 371,FOR THE PROPOSAL - YES,320023,4,3,70,77
HUGHES,STATE QUESTION NO. 794 LEGISLATIVE REFERENDUM NO. 371,AGAINST THE PROPOSAL - NO,320023,2,3,13,18
HUGHES,STATE QUESTION NO. 794 LEGISLATIVE REFERENDUM NO. 371,FOR THE PROPOSAL - YES,320030,5,4,112,121
HUGHES,STATE QUESTION NO. 794 LEGISLATIVE REFERENDUM NO. 371,AGAINST THE PROPOSAL - NO,320030,0,1,34,35
HUGHES,STATE QUESTION NO. 794 LEGISLATIVE REFERENDUM NO. 371,FOR THE PROPOSAL - YES,320031,3,6,162,171
HUGHES,STATE QUESTION NO. 794 LEGISLATIVE REFERENDUM NO. 371,AGAINST THE PROPOSAL - NO,320031,1,1,38,40
HUGHES,STATE QUESTION NO. 794 LEGISLATIVE REFERENDUM NO. 371,FOR THE PROPOSAL - YES,320032,2,0,154,156
HUGHES,STATE QUESTION NO. 794 LEGISLATIVE REFERENDUM NO. 371,AGAINST THE PROPOSAL - NO,320032,3,0,34,37
HUGHES,STATE QUESTION NO. 794 LEGISLATIVE REFERENDUM NO. 371,FOR THE PROPOSAL - YES,320033,2,7,153,162
HUGHES,STATE QUESTION NO. 794 LEGISLATIVE REFERENDUM NO. 371,AGAINST THE PROPOSAL - NO,320033,0,1,44,45
HUGHES,STATE QUESTION NO. 794 LEGISLATIVE REFERENDUM NO. 371,FOR THE PROPOSAL - YES,320034,3,5,97,105
HUGHES,STATE QUESTION NO. 794 LEGISLATIVE REFERENDUM NO. 371,AGAINST THE PROPOSAL - NO,320034,0,4,31,35
HUGHES,STATE QUESTION NO. 794 LEGISLATIVE REFERENDUM NO. 371,FOR THE PROPOSAL - YES,320035,6,56,323,385
HUGHES,STATE QUESTION NO. 794 LEGISLATIVE REFERENDUM NO. 371,AGAINST THE PROPOSAL - NO,320035,3,10,99,112
JACKSON,STATE QUESTION NO. 794 LEGISLATIVE REFERENDUM NO. 371,FOR THE PROPOSAL - YES,330001,44,162,576,782
JACKSON,STATE QUESTION NO. 794 LEGISLATIVE REFERENDUM NO. 371,AGAINST THE PROPOSAL - NO,330001,12,79,276,367
JACKSON,STATE QUESTION NO. 794 LEGISLATIVE REFERENDUM NO. 371,FOR THE PROPOSAL - YES,330002,25,72,184,281
JACKSON,STATE QUESTION NO. 794 LEGISLATIVE REFERENDUM NO. 371,AGAINST THE PROPOSAL - NO,330002,7,24,95,126
JACKSON,STATE QUESTION NO. 794 LEGISLATIVE REFERENDUM NO. 371,FOR THE PROPOSAL - YES,330003,2,33,249,284
JACKSON,STATE QUESTION NO. 794 LEGISLATIVE REFERENDUM NO. 371,AGAINST THE PROPOSAL - NO,330003,3,14,108,125
JACKSON,STATE QUESTION NO. 794 LEGISLATIVE REFERENDUM NO. 371,FOR THE PROPOSAL - YES,330006,30,109,434,573
JACKSON,STATE QUESTION NO. 794 LEGISLATIVE REFERENDUM NO. 371,AGAINST THE PROPOSAL - NO,330006,5,46,213,264
JACKSON,STATE QUESTION NO. 794 LEGISLATIVE REFERENDUM NO. 371,FOR THE PROPOSAL - YES,330007,8,41,298,347
JACKSON,STATE QUESTION NO. 794 LEGISLATIVE REFERENDUM NO. 371,AGAINST THE PROPOSAL - NO,330007,3,18,106,127
JACKSON,STATE QUESTION NO. 794 LEGISLATIVE REFERENDUM NO. 371,FOR THE PROPOSAL - YES,330010,10,30,191,231
JACKSON,STATE QUESTION NO. 794 LEGISLATIVE REFERENDUM NO. 371,AGAINST THE PROPOSAL - NO,330010,2,19,73,94
JACKSON,STATE QUESTION NO. 794 LEGISLATIVE REFERENDUM NO. 371,FOR THE PROPOSAL - YES,330014,23,98,417,538
JACKSON,STATE QUESTION NO. 794 LEGISLATIVE REFERENDUM NO. 371,AGAINST THE PROPOSAL - NO,330014,8,43,163,214
JACKSON,STATE QUESTION NO. 794 LEGISLATIVE REFERENDUM NO. 371,FOR THE PROPOSAL - YES,330016,13,22,219,254
JACKSON,STATE QUESTION NO. 794 LEGISLATIVE REFERENDUM NO. 371,AGAINST THE PROPOSAL - NO,330016,0,6,117,123
JACKSON,STATE QUESTION NO. 794 LEGISLATIVE REFERENDUM NO. 371,FOR THE PROPOSAL - YES,330017,2,4,128,134
JACKSON,STATE QUESTION NO. 794 LEGISLATIVE REFERENDUM NO. 371,AGAINST THE PROPOSAL - NO,330017,4,5,88,97
JACKSON,STATE QUESTION NO. 794 LEGISLATIVE REFERENDUM NO. 371,FOR THE PROPOSAL - YES,330018,3,2,103,108
JACKSON,STATE QUESTION NO. 794 LEGISLATIVE REFERENDUM NO. 371,AGAINST THE PROPOSAL - NO,330018,0,3,22,25
JACKSON,STATE QUESTION NO. 794 LEGISLATIVE REFERENDUM NO. 371,FOR THE PROPOSAL - YES,330019,3,10,79,92
JACKSON,STATE QUESTION NO. 794 LEGISLATIVE REFERENDUM NO. 371,AGAINST THE PROPOSAL - NO,330019,0,4,31,35
JACKSON,STATE QUESTION NO. 794 LEGISLATIVE REFERENDUM NO. 371,FOR THE PROPOSAL - YES,330020,7,52,287,346
JACKSON,STATE QUESTION NO. 794 LEGISLATIVE REFERENDUM NO. 371,AGAINST THE PROPOSAL - NO,330020,7,34,156,197
JACKSON,STATE QUESTION NO. 794 LEGISLATIVE REFERENDUM NO. 371,FOR THE PROPOSAL - YES,330021,3,7,51,61
JACKSON,STATE QUESTION NO. 794 LEGISLATIVE REFERENDUM NO. 371,AGAINST THE PROPOSAL - NO,330021,0,2,24,26
JACKSON,STATE QUESTION NO. 794 LEGISLATIVE REFERENDUM NO. 371,FOR THE PROPOSAL - YES,330023,5,24,169,198
JACKSON,STATE QUESTION NO. 794 LEGISLATIVE REFERENDUM NO. 371,AGAINST THE PROPOSAL - NO,330023,0,20,67,87
JACKSON,STATE QUESTION NO. 794 LEGISLATIVE REFERENDUM NO. 371,FOR THE PROPOSAL - YES,330024,2,10,108,120
JACKSON,STATE QUESTION NO. 794 LEGISLATIVE REFERENDUM NO. 371,AGAINST THE PROPOSAL - NO,330024,1,3,27,31
JEFFERSON,STATE QUESTION NO. 794 LEGISLATIVE REFERENDUM NO. 371,FOR THE PROPOSAL - YES,340001,4,27,135,166
JEFFERSON,STATE QUESTION NO. 794 LEGISLATIVE REFERENDUM NO. 371,AGAINST THE PROPOSAL - NO,340001,2,8,44,54
JEFFERSON,STATE QUESTION NO. 794 LEGISLATIVE REFERENDUM NO. 371,FOR THE PROPOSAL - YES,340002,3,25,123,151
JEFFERSON,STATE QUESTION NO. 794 LEGISLATIVE REFERENDUM NO. 371,AGAINST THE PROPOSAL - NO,340002,3,12,40,55
JEFFERSON,STATE QUESTION NO. 794 LEGISLATIVE REFERENDUM NO. 371,FOR THE PROPOSAL - YES,340003,6,14,47,67
JEFFERSON,STATE QUESTION NO. 794 LEGISLATIVE REFERENDUM NO. 371,AGAINST THE PROPOSAL - NO,340003,2,4,21,27
JEFFERSON,STATE QUESTION NO. 794 LEGISLATIVE REFERENDUM NO. 371,FOR THE PROPOSAL - YES,340004,0,12,56,68
JEFFERSON,STATE QUESTION NO. 794 LEGISLATIVE REFERENDUM NO. 371,AGAINST THE PROPOSAL - NO,340004,0,1,11,12
JEFFERSON,STATE QUESTION NO. 794 LEGISLATIVE REFERENDUM NO. 371,FOR THE PROPOSAL - YES,340005,1,6,27,34
JEFFERSON,STATE QUESTION NO. 794 LEGISLATIVE REFERENDUM NO. 371,AGAINST THE PROPOSAL - NO,340005,0,2,9,11
JEFFERSON,STATE QUESTION NO. 794 LEGISLATIVE REFERENDUM NO. 371,FOR THE PROPOSAL - YES,340006,3,11,142,156
JEFFERSON,STATE QUESTION NO. 794 LEGISLATIVE REFERENDUM NO. 371,AGAINST THE PROPOSAL - NO,340006,0,7,57,64
JEFFERSON,STATE QUESTION NO. 794 LEGISLATIVE REFERENDUM NO. 371,FOR THE PROPOSAL - YES,340007,1,3,69,73
JEFFERSON,STATE QUESTION NO. 794 LEGISLATIVE REFERENDUM NO. 371,AGAINST THE PROPOSAL - NO,340007,1,1,34,36
JEFFERSON,STATE QUESTION NO. 794 LEGISLATIVE REFERENDUM NO. 371,FOR THE PROPOSAL - YES,340008,0,6,18,24
JEFFERSON,STATE QUESTION NO. 794 LEGISLATIVE REFERENDUM NO. 371,AGAINST THE PROPOSAL - NO,340008,0,1,3,4
JEFFERSON,STATE QUESTION NO. 794 LEGISLATIVE REFERENDUM NO. 371,FOR THE PROPOSAL - YES,340009,8,15,297,320
JEFFERSON,STATE QUESTION NO. 794 LEGISLATIVE REFERENDUM NO. 371,AGAINST THE PROPOSAL - NO,340009,2,4,120,126
JEFFERSON,STATE QUESTION NO. 794 LEGISLATIVE REFERENDUM NO. 371,FOR THE PROPOSAL - YES,340010,2,1,22,25
JEFFERSON,STATE QUESTION NO. 794 LEGISLATIVE REFERENDUM NO. 371,AGAINST THE PROPOSAL - NO,340010,0,0,7,7
JOHNSTON,STATE QUESTION NO. 794 LEGISLATIVE REFERENDUM NO. 371,FOR THE PROPOSAL - YES,350001,5,50,162,217
JOHNSTON,STATE QUESTION NO. 794 LEGISLATIVE REFERENDUM NO. 371,AGAINST THE PROPOSAL - NO,350001,2,16,48,66
JOHNSTON,STATE QUESTION NO. 794 LEGISLATIVE REFERENDUM NO. 371,FOR THE PROPOSAL - YES,350002,3,19,113,135
JOHNSTON,STATE QUESTION NO. 794 LEGISLATIVE REFERENDUM NO. 371,AGAINST THE PROPOSAL - NO,350002,2,4,25,31
JOHNSTON,STATE QUESTION NO. 794 LEGISLATIVE REFERENDUM NO. 371,FOR THE PROPOSAL - YES,350003,2,38,105,145
JOHNSTON,STATE QUESTION NO. 794 LEGISLATIVE REFERENDUM NO. 371,AGAINST THE PROPOSAL - NO,350003,1,7,30,38
JOHNSTON,STATE QUESTION NO. 794 LEGISLATIVE REFERENDUM NO. 371,FOR THE PROPOSAL - YES,350004,8,91,325,424
JOHNSTON,STATE QUESTION NO. 794 LEGISLATIVE REFERENDUM NO. 371,AGAINST THE PROPOSAL - NO,350004,2,29,82,113
JOHNSTON,STATE QUESTION NO. 794 LEGISLATIVE REFERENDUM NO. 371,FOR THE PROPOSAL - YES,350005,2,9,236,247
JOHNSTON,STATE QUESTION NO. 794 LEGISLATIVE REFERENDUM NO. 371,AGAINST THE PROPOSAL - NO,350005,2,2,41,45
JOHNSTON,STATE QUESTION NO. 794 LEGISLATIVE REFERENDUM NO. 371,FOR THE PROPOSAL - YES,350006,2,22,149,173
JOHNSTON,STATE QUESTION NO. 794 LEGISLATIVE REFERENDUM NO. 371,AGAINST THE PROPOSAL - NO,350006,1,4,52,57
JOHNSTON,STATE QUESTION NO. 794 LEGISLATIVE REFERENDUM NO. 371,FOR THE PROPOSAL - YES,350007,0,1,4,5
JOHNSTON,STATE QUESTION NO. 794 LEGISLATIVE REFERENDUM NO. 371,AGAINST THE PROPOSAL - NO,350007,0,0,2,2
JOHNSTON,STATE QUESTION NO. 794 LEGISLATIVE REFERENDUM NO. 371,FOR THE PROPOSAL - YES,350008,2,5,122,129
JOHNSTON,STATE QUESTION NO. 794 LEGISLATIVE REFERENDUM NO. 371,AGAINST THE PROPOSAL - NO,350008,2,0,40,42
JOHNSTON,STATE QUESTION NO. 794 LEGISLATIVE REFERENDUM NO. 371,FOR THE PROPOSAL - YES,350009,1,5,79,85
JOHNSTON,STATE QUESTION NO. 794 LEGISLATIVE REFERENDUM NO. 371,AGAINST THE PROPOSAL - NO,350009,0,2,24,26
JOHNSTON,STATE QUESTION NO. 794 LEGISLATIVE REFERENDUM NO. 371,FOR THE PROPOSAL - YES,350010,0,3,51,54
JOHNSTON,STATE QUESTION NO. 794 LEGISLATIVE REFERENDUM NO. 371,AGAINST THE PROPOSAL - NO,350010,0,2,18,20
JOHNSTON,STATE QUESTION NO. 794 LEGISLATIVE REFERENDUM NO. 371,FOR THE PROPOSAL - YES,350011,0,3,98,101
JOHNSTON,STATE QUESTION NO. 794 LEGISLATIVE REFERENDUM NO. 371,AGAINST THE PROPOSAL - NO,350011,0,0,29,29
JOHNSTON,STATE QUESTION NO. 794 LEGISLATIVE REFERENDUM NO. 371,FOR THE PROPOSAL - YES,350012,5,12,221,238
JOHNSTON,STATE QUESTION NO. 794 LEGISLATIVE REFERENDUM NO. 371,AGAINST THE PROPOSAL - NO,350012,2,6,69,77
JOHNSTON,STATE QUESTION NO. 794 LEGISLATIVE REFERENDUM NO. 371,FOR THE PROPOSAL - YES,350013,7,37,251,295
JOHNSTON,STATE QUESTION NO. 794 LEGISLATIVE REFERENDUM NO. 371,AGAINST THE PROPOSAL - NO,350013,2,16,75,93
JOHNSTON,STATE QUESTION NO. 794 LEGISLATIVE REFERENDUM NO. 371,FOR THE PROPOSAL - YES,350014,1,5,51,57
JOHNSTON,STATE QUESTION NO. 794 LEGISLATIVE REFERENDUM NO. 371,AGAINST THE PROPOSAL - NO,350014,2,0,17,19
KAY,STATE QUESTION NO. 794 LEGISLATIVE REFERENDUM NO. 371,FOR THE PROPOSAL - YES,360001,18,65,432,515
KAY,STATE QUESTION NO. 794 LEGISLATIVE REFERENDUM NO. 371,AGAINST THE PROPOSAL - NO,360001,5,21,108,134
KAY,STATE QUESTION NO. 794 LEGISLATIVE REFERENDUM NO. 371,FOR THE PROPOSAL - YES,360101,9,21,384,414
KAY,STATE QUESTION NO. 794 LEGISLATIVE REFERENDUM NO. 371,AGAINST THE PROPOSAL - NO,360101,1,6,92,99
KAY,STATE QUESTION NO. 794 LEGISLATIVE REFERENDUM NO. 371,FOR THE PROPOSAL - YES,360103,16,10,404,430
KAY,STATE QUESTION NO. 794 LEGISLATIVE REFERENDUM NO. 371,AGAINST THE PROPOSAL - NO,360103,0,3,99,102
KAY,STATE QUESTION NO. 794 LEGISLATIVE REFERENDUM NO. 371,FOR THE PROPOSAL - YES,360202,8,13,411,432
KAY,STATE QUESTION NO. 794 LEGISLATIVE REFERENDUM NO. 371,AGAINST THE PROPOSAL - NO,360202,6,3,102,111
KAY,STATE QUESTION NO. 794 LEGISLATIVE REFERENDUM NO. 371,FOR THE PROPOSAL - YES,360205,9,7,419,435
KAY,STATE QUESTION NO. 794 LEGISLATIVE REFERENDUM NO. 371,AGAINST THE PROPOSAL - NO,360205,2,6,85,93
KAY,STATE QUESTION NO. 794 LEGISLATIVE REFERENDUM NO. 371,FOR THE PROPOSAL - YES,360206,18,26,607,651
KAY,STATE QUESTION NO. 794 LEGISLATIVE REFERENDUM NO. 371,AGAINST THE PROPOSAL - NO,360206,14,14,134,162
KAY,STATE QUESTION NO. 794 LEGISLATIVE REFERENDUM NO. 371,FOR THE PROPOSAL - YES,360400,6,2,65,73
KAY,STATE QUESTION NO. 794 LEGISLATIVE REFERENDUM NO. 371,AGAINST THE PROPOSAL - NO,360400,1,1,16,18
KAY,STATE QUESTION NO. 794 LEGISLATIVE REFERENDUM NO. 371,FOR THE PROPOSAL - YES,360401,0,4,41,45
KAY,STATE QUESTION NO. 794 LEGISLATIVE REFERENDUM NO. 371,AGAINST THE PROPOSAL - NO,360401,0,2,8,10
KAY,STATE QUESTION NO. 794 LEGISLATIVE REFERENDUM NO. 371,FOR THE PROPOSAL - YES,360403,6,33,253,292
KAY,STATE QUESTION NO. 794 LEGISLATIVE REFERENDUM NO. 371,AGAINST THE PROPOSAL - NO,360403,3,12,59,74
KAY,STATE QUESTION NO. 794 LEGISLATIVE REFERENDUM NO. 371,FOR THE PROPOSAL - YES,360404,5,7,99,111
KAY,STATE QUESTION NO. 794 LEGISLATIVE REFERENDUM NO. 371,AGAINST THE PROPOSAL - NO,360404,0,1,22,23
KAY,STATE QUESTION NO. 794 LEGISLATIVE REFERENDUM NO. 371,FOR THE PROPOSAL - YES,360406,2,9,120,131
KAY,STATE QUESTION NO. 794 LEGISLATIVE REFERENDUM NO. 371,AGAINST THE PROPOSAL - NO,360406,0,3,36,39
KAY,STATE QUESTION NO. 794 LEGISLATIVE REFERENDUM NO. 371,FOR THE PROPOSAL - YES,360407,0,1,20,21
KAY,STATE QUESTION NO. 794 LEGISLATIVE REFERENDUM NO. 371,AGAINST THE PROPOSAL - NO,360407,0,0,6,6
KAY,STATE QUESTION NO. 794 LEGISLATIVE REFERENDUM NO. 371,FOR THE PROPOSAL - YES,360409,2,6,35,43
KAY,STATE QUESTION NO. 794 LEGISLATIVE REFERENDUM NO. 371,AGAINST THE PROPOSAL - NO,360409,0,2,15,17
KAY,STATE QUESTION NO. 794 LEGISLATIVE REFERENDUM NO. 371,FOR THE PROPOSAL - YES,360411,3,2,103,108
KAY,STATE QUESTION NO. 794 LEGISLATIVE REFERENDUM NO. 371,AGAINST THE PROPOSAL - NO,360411,0,2,21,23
KAY,STATE QUESTION NO. 794 LEGISLATIVE REFERENDUM NO. 371,FOR THE PROPOSAL - YES,360412,6,1,171,178
KAY,STATE QUESTION NO. 794 LEGISLATIVE REFERENDUM NO. 371,AGAINST THE PROPOSAL - NO,360412,0,1,32,33
KAY,STATE QUESTION NO. 794 LEGISLATIVE REFERENDUM NO. 371,FOR THE PROPOSAL - YES,360413,26,51,566,643
KAY,STATE QUESTION NO. 794 LEGISLATIVE REFERENDUM NO. 371,AGAINST THE PROPOSAL - NO,360413,8,20,150,178
KAY,STATE QUESTION NO. 794 LEGISLATIVE REFERENDUM NO. 371,FOR THE PROPOSAL - YES,360419,14,8,314,336
KAY,STATE QUESTION NO. 794 LEGISLATIVE REFERENDUM NO. 371,AGAINST THE PROPOSAL - NO,360419,1,1,66,68
KAY,STATE QUESTION NO. 794 LEGISLATIVE REFERENDUM NO. 371,FOR THE PROPOSAL - YES,360420,6,2,171,179
KAY,STATE QUESTION NO. 794 LEGISLATIVE REFERENDUM NO. 371,AGAINST THE PROPOSAL - NO,360420,2,0,41,43
KAY,STATE QUESTION NO. 794 LEGISLATIVE REFERENDUM NO. 371,FOR THE PROPOSAL - YES,360503,31,29,583,643
KAY,STATE QUESTION NO. 794 LEGISLATIVE REFERENDUM NO. 371,AGAINST THE PROPOSAL - NO,360503,5,14,118,137
KAY,STATE QUESTION NO. 794 LEGISLATIVE REFERENDUM NO. 371,FOR THE PROPOSAL - YES,360507,9,17,347,373
KAY,STATE QUESTION NO. 794 LEGISLATIVE REFERENDUM NO. 371,AGAINST THE PROPOSAL - NO,360507,5,1,85,91
KAY,STATE QUESTION NO. 794 LEGISLATIVE REFERENDUM NO. 371,FOR THE PROPOSAL - YES,360516,5,8,310,323
KAY,STATE QUESTION NO. 794 LEGISLATIVE REFERENDUM NO. 371,AGAINST THE PROPOSAL - NO,360516,1,2,63,66
KAY,STATE QUESTION NO. 794 LEGISLATIVE REFERENDUM NO. 371,FOR THE PROPOSAL - YES,360517,12,13,409,434
KAY,STATE QUESTION NO. 794 LEGISLATIVE REFERENDUM NO. 371,AGAINST THE PROPOSAL - NO,360517,2,4,85,91
KAY,STATE QUESTION NO. 794 LEGISLATIVE REFERENDUM NO. 371,FOR THE PROPOSAL - YES,360527,24,35,552,611
KAY,STATE QUESTION NO. 794 LEGISLATIVE REFERENDUM NO. 371,AGAINST THE PROPOSAL - NO,360527,12,7,98,117
KAY,STATE QUESTION NO. 794 LEGISLATIVE REFERENDUM NO. 371,FOR THE PROPOSAL - YES,360530,11,24,462,497
KAY,STATE QUESTION NO. 794 LEGISLATIVE REFERENDUM NO. 371,AGAINST THE PROPOSAL - NO,360530,5,4,113,122
KAY,STATE QUESTION NO. 794 LEGISLATIVE REFERENDUM NO. 371,FOR THE PROPOSAL - YES,360532,15,33,485,533
KAY,STATE QUESTION NO. 794 LEGISLATIVE REFERENDUM NO. 371,AGAINST THE PROPOSAL - NO,360532,9,11,123,143
KAY,STATE QUESTION NO. 794 LEGISLATIVE REFERENDUM NO. 371,FOR THE PROPOSAL - YES,360533,23,23,478,524
KAY,STATE QUESTION NO. 794 LEGISLATIVE REFERENDUM NO. 371,AGAINST THE PROPOSAL - NO,360533,7,6,120,133
KAY,STATE QUESTION NO. 794 LEGISLATIVE REFERENDUM NO. 371,FOR THE PROPOSAL - YES,360534,31,57,625,713
KAY,STATE QUESTION NO. 794 LEGISLATIVE REFERENDUM NO. 371,AGAINST THE PROPOSAL - NO,360534,6,9,149,164
KAY,STATE QUESTION NO. 794 LEGISLATIVE REFERENDUM NO. 371,FOR THE PROPOSAL - YES,360535,36,57,537,630
KAY,STATE QUESTION NO. 794 LEGISLATIVE REFERENDUM NO. 371,AGAINST THE PROPOSAL - NO,360535,16,19,146,181
KINGFISHER,STATE QUESTION NO. 794 LEGISLATIVE REFERENDUM NO. 371,FOR THE PROPOSAL - YES,370101,28,122,588,738
KINGFISHER,STATE QUESTION NO. 794 LEGISLATIVE REFERENDUM NO. 371,AGAINST THE PROPOSAL - NO,370101,8,14,145,167
KINGFISHER,STATE QUESTION NO. 794 LEGISLATIVE REFERENDUM NO. 371,FOR THE PROPOSAL - YES,370102,10,21,148,179
KINGFISHER,STATE QUESTION NO. 794 LEGISLATIVE REFERENDUM NO. 371,AGAINST THE PROPOSAL - NO,370102,0,0,34,34
KINGFISHER,STATE QUESTION NO. 794 LEGISLATIVE REFERENDUM NO. 371,FOR THE PROPOSAL - YES,370103,11,41,197,249
KINGFISHER,STATE QUESTION NO. 794 LEGISLATIVE REFERENDUM NO. 371,AGAINST THE PROPOSAL - NO,370103,3,8,43,54
KINGFISHER,STATE QUESTION NO. 794 LEGISLATIVE REFERENDUM NO. 371,FOR THE PROPOSAL - YES,370105,26,29,404,459
KINGFISHER,STATE QUESTION NO. 794 LEGISLATIVE REFERENDUM NO. 371,AGAINST THE PROPOSAL - NO,370105,4,10,136,150
KINGFISHER,STATE QUESTION NO. 794 LEGISLATIVE REFERENDUM NO. 371,FOR THE PROPOSAL - YES,370106,1,9,47,57
KINGFISHER,STATE QUESTION NO. 794 LEGISLATIVE REFERENDUM NO. 371,AGAINST THE PROPOSAL - NO,370106,2,2,17,21
KINGFISHER,STATE QUESTION NO. 794 LEGISLATIVE REFERENDUM NO. 371,FOR THE PROPOSAL - YES,370201,16,27,613,656
KINGFISHER,STATE QUESTION NO. 794 LEGISLATIVE REFERENDUM NO. 371,AGAINST THE PROPOSAL - NO,370201,9,5,183,197
KINGFISHER,STATE QUESTION NO. 794 LEGISLATIVE REFERENDUM NO. 371,FOR THE PROPOSAL - YES,370203,9,1,70,80
KINGFISHER,STATE QUESTION NO. 794 LEGISLATIVE REFERENDUM NO. 371,AGAINST THE PROPOSAL - NO,370203,5,1,25,31
KINGFISHER,STATE QUESTION NO. 794 LEGISLATIVE REFERENDUM NO. 371,FOR THE PROPOSAL - YES,370204,2,23,158,183
KINGFISHER,STATE QUESTION NO. 794 LEGISLATIVE REFERENDUM NO. 371,AGAINST THE PROPOSAL - NO,370204,0,5,39,44
KINGFISHER,STATE QUESTION NO. 794 LEGISLATIVE REFERENDUM NO. 371,FOR THE PROPOSAL - YES,370301,20,117,619,756
KINGFISHER,STATE QUESTION NO. 794 LEGISLATIVE REFERENDUM NO. 371,AGAINST THE PROPOSAL - NO,370301,2,17,126,145
KINGFISHER,STATE QUESTION NO. 794 LEGISLATIVE REFERENDUM NO. 371,FOR THE PROPOSAL - YES,370302,6,10,313,329
KINGFISHER,STATE QUESTION NO. 794 LEGISLATIVE REFERENDUM NO. 371,AGAINST THE PROPOSAL - NO,370302,1,3,82,86
KINGFISHER,STATE QUESTION NO. 794 LEGISLATIVE REFERENDUM NO. 371,FOR THE PROPOSAL - YES,370303,4,5,83,92
KINGFISHER,STATE QUESTION NO. 794 LEGISLATIVE REFERENDUM NO. 371,AGAINST THE PROPOSAL - NO,370303,0,3,17,20
KINGFISHER,STATE QUESTION NO. 794 LEGISLATIVE REFERENDUM NO. 371,FOR THE PROPOSAL - YES,370304,2,11,102,115
KINGFISHER,STATE QUESTION NO. 794 LEGISLATIVE REFERENDUM NO. 371,AGAINST THE PROPOSAL - NO,370304,1,0,29,30
KINGFISHER,STATE QUESTION NO. 794 LEGISLATIVE REFERENDUM NO. 371,FOR THE PROPOSAL - YES,370305,4,21,111,136
KINGFISHER,STATE QUESTION NO. 794 LEGISLATIVE REFERENDUM NO. 371,AGAINST THE PROPOSAL - NO,370305,0,1,20,21
KINGFISHER,STATE QUESTION NO. 794 LEGISLATIVE REFERENDUM NO. 371,FOR THE PROPOSAL - YES,370306,0,0,13,13
KINGFISHER,STATE QUESTION NO. 794 LEGISLATIVE REFERENDUM NO. 371,AGAINST THE PROPOSAL - NO,370306,0,0,7,7
KIOWA,STATE QUESTION NO. 794 LEGISLATIVE REFERENDUM NO. 371,FOR THE PROPOSAL - YES,380001,14,76,295,385
KIOWA,STATE QUESTION NO. 794 LEGISLATIVE REFERENDUM NO. 371,AGAINST THE PROPOSAL - NO,380001,6,26,114,146
KIOWA,STATE QUESTION NO. 794 LEGISLATIVE REFERENDUM NO. 371,FOR THE PROPOSAL - YES,380002,1,15,73,89
KIOWA,STATE QUESTION NO. 794 LEGISLATIVE REFERENDUM NO. 371,AGAINST THE PROPOSAL - NO,380002,2,9,24,35
KIOWA,STATE QUESTION NO. 794 LEGISLATIVE REFERENDUM NO. 371,FOR THE PROPOSAL - YES,380004,7,66,207,280
KIOWA,STATE QUESTION NO. 794 LEGISLATIVE REFERENDUM NO. 371,AGAINST THE PROPOSAL - NO,380004,2,23,78,103
KIOWA,STATE QUESTION NO. 794 LEGISLATIVE REFERENDUM NO. 371,FOR THE PROPOSAL - YES,380005,1,5,27,33
KIOWA,STATE QUESTION NO. 794 LEGISLATIVE REFERENDUM NO. 371,AGAINST THE PROPOSAL - NO,380005,0,0,4,4
KIOWA,STATE QUESTION NO. 794 LEGISLATIVE REFERENDUM NO. 371,FOR THE PROPOSAL - YES,380006,4,9,83,96
KIOWA,STATE QUESTION NO. 794 LEGISLATIVE REFERENDUM NO. 371,AGAINST THE PROPOSAL - NO,380006,1,5,43,49
KIOWA,STATE QUESTION NO. 794 LEGISLATIVE REFERENDUM NO. 371,FOR THE PROPOSAL - YES,380007,0,0,6,6
KIOWA,STATE QUESTION NO. 794 LEGISLATIVE REFERENDUM NO. 371,AGAINST THE PROPOSAL - NO,380007,0,0,3,3
KIOWA,STATE QUESTION NO. 794 LEGISLATIVE REFERENDUM NO. 371,FOR THE PROPOSAL - YES,380008,4,7,125,136
KIOWA,STATE QUESTION NO. 794 LEGISLATIVE REFERENDUM NO. 371,AGAINST THE PROPOSAL - NO,380008,3,4,40,47
KIOWA,STATE QUESTION NO. 794 LEGISLATIVE REFERENDUM NO. 371,FOR THE PROPOSAL - YES,380009,1,2,15,18
KIOWA,STATE QUESTION NO. 794 LEGISLATIVE REFERENDUM NO. 371,AGAINST THE PROPOSAL - NO,380009,0,0,4,4
KIOWA,STATE QUESTION NO. 794 LEGISLATIVE REFERENDUM NO. 371,FOR THE PROPOSAL - YES,380010,8,8,262,278
KIOWA,STATE QUESTION NO. 794 LEGISLATIVE REFERENDUM NO. 371,AGAINST THE PROPOSAL - NO,380010,7,2,70,79
KIOWA,STATE QUESTION NO. 794 LEGISLATIVE REFERENDUM NO. 371,FOR THE PROPOSAL - YES,380011,4,4,53,61
KIOWA,STATE QUESTION NO. 794 LEGISLATIVE REFERENDUM NO. 371,AGAINST THE PROPOSAL - NO,380011,2,3,33,38
KIOWA,STATE QUESTION NO. 794 LEGISLATIVE REFERENDUM NO. 371,FOR THE PROPOSAL - YES,380014,11,1,331,343
KIOWA,STATE QUESTION NO. 794 LEGISLATIVE REFERENDUM NO. 371,AGAINST THE PROPOSAL - NO,380014,3,1,87,91
KIOWA,STATE QUESTION NO. 794 LEGISLATIVE REFERENDUM NO. 371,FOR THE PROPOSAL - YES,380015,2,8,68,78
KIOWA,STATE QUESTION NO. 794 LEGISLATIVE REFERENDUM NO. 371,AGAINST THE PROPOSAL - NO,380015,1,5,33,39
KIOWA,STATE QUESTION NO. 794 LEGISLATIVE REFERENDUM NO. 371,FOR THE PROPOSAL - YES,380016,0,12,42,54
KIOWA,STATE QUESTION NO. 794 LEGISLATIVE REFERENDUM NO. 371,AGAINST THE PROPOSAL - NO,380016,2,6,14,22
KIOWA,STATE QUESTION NO. 794 LEGISLATIVE REFERENDUM NO. 371,FOR THE PROPOSAL - YES,380022,5,4,106,115
KIOWA,STATE QUESTION NO. 794 LEGISLATIVE REFERENDUM NO. 371,AGAINST THE PROPOSAL - NO,380022,2,4,23,29
LATIMER,STATE QUESTION NO. 794 LEGISLATIVE REFERENDUM NO. 371,FOR THE PROPOSAL - YES,390001,2,28,181,211
LATIMER,STATE QUESTION NO. 794 LEGISLATIVE REFERENDUM NO. 371,AGAINST THE PROPOSAL - NO,390001,4,15,42,61
LATIMER,STATE QUESTION NO. 794 LEGISLATIVE REFERENDUM NO. 371,FOR THE PROPOSAL - YES,390002,13,29,227,269
LATIMER,STATE QUESTION NO. 794 LEGISLATIVE REFERENDUM NO. 371,AGAINST THE PROPOSAL - NO,390002,4,6,50,60
LATIMER,STATE QUESTION NO. 794 LEGISLATIVE REFERENDUM NO. 371,FOR THE PROPOSAL - YES,390003,2,31,140,173
LATIMER,STATE QUESTION NO. 794 LEGISLATIVE REFERENDUM NO. 371,AGAINST THE PROPOSAL - NO,390003,1,12,21,34
LATIMER,STATE QUESTION NO. 794 LEGISLATIVE REFERENDUM NO. 371,FOR THE PROPOSAL - YES,390004,3,19,115,137
LATIMER,STATE QUESTION NO. 794 LEGISLATIVE REFERENDUM NO. 371,AGAINST THE PROPOSAL - NO,390004,2,6,19,27
LATIMER,STATE QUESTION NO. 794 LEGISLATIVE REFERENDUM NO. 371,FOR THE PROPOSAL - YES,390005,7,30,243,280
LATIMER,STATE QUESTION NO. 794 LEGISLATIVE REFERENDUM NO. 371,AGAINST THE PROPOSAL - NO,390005,1,7,62,70
LATIMER,STATE QUESTION NO. 794 LEGISLATIVE REFERENDUM NO. 371,FOR THE PROPOSAL - YES,390006,4,4,88,96
LATIMER,STATE QUESTION NO. 794 LEGISLATIVE REFERENDUM NO. 371,AGAINST THE PROPOSAL - NO,390006,0,3,17,20
LATIMER,STATE QUESTION NO. 794 LEGISLATIVE REFERENDUM NO. 371,FOR THE PROPOSAL - YES,390007,2,8,86,96
LATIMER,STATE QUESTION NO. 794 LEGISLATIVE REFERENDUM NO. 371,AGAINST THE PROPOSAL - NO,390007,5,2,19,26
LATIMER,STATE QUESTION NO. 794 LEGISLATIVE REFERENDUM NO. 371,FOR THE PROPOSAL - YES,390008,2,8,197,207
LATIMER,STATE QUESTION NO. 794 LEGISLATIVE REFERENDUM NO. 371,AGAINST THE PROPOSAL - NO,390008,3,4,58,65
LATIMER,STATE QUESTION NO. 794 LEGISLATIVE REFERENDUM NO. 371,FOR THE PROPOSAL - YES,390009,8,8,172,188
LATIMER,STATE QUESTION NO. 794 LEGISLATIVE REFERENDUM NO. 371,AGAINST THE PROPOSAL - NO,390009,1,0,40,41
LATIMER,STATE QUESTION NO. 794 LEGISLATIVE REFERENDUM NO. 371,FOR THE PROPOSAL - YES,390010,8,27,137,172
LATIMER,STATE QUESTION NO. 794 LEGISLATIVE REFERENDUM NO. 371,AGAINST THE PROPOSAL - NO,390010,3,7,30,40
LATIMER,STATE QUESTION NO. 794 LEGISLATIVE REFERENDUM NO. 371,FOR THE PROPOSAL - YES,390011,12,18,328,358
LATIMER,STATE QUESTION NO. 794 LEGISLATIVE REFERENDUM NO. 371,AGAINST THE PROPOSAL - NO,390011,6,6,121,133
LATIMER,STATE QUESTION NO. 794 LEGISLATIVE REFERENDUM NO. 371,FOR THE PROPOSAL - YES,390012,3,8,91,102
LATIMER,STATE QUESTION NO. 794 LEGISLATIVE REFERENDUM NO. 371,AGAINST THE PROPOSAL - NO,390012,4,4,42,50
LEFLORE,STATE QUESTION NO. 794 LEGISLATIVE REFERENDUM NO. 371,FOR THE PROPOSAL - YES,400101,4,11,170,185
LEFLORE,STATE QUESTION NO. 794 LEGISLATIVE REFERENDUM NO. 371,AGAINST THE PROPOSAL - NO,400101,6,3,82,91
LEFLORE,STATE QUESTION NO. 794 LEGISLATIVE REFERENDUM NO. 371,FOR THE PROPOSAL - YES,400102,8,12,206,226
LEFLORE,STATE QUESTION NO. 794 LEGISLATIVE REFERENDUM NO. 371,AGAINST THE PROPOSAL - NO,400102,6,3,88,97
LEFLORE,STATE QUESTION NO. 794 LEGISLATIVE REFERENDUM NO. 371,FOR THE PROPOSAL - YES,400103,15,15,310,340
LEFLORE,STATE QUESTION NO. 794 LEGISLATIVE REFERENDUM NO. 371,AGAINST THE PROPOSAL - NO,400103,3,14,143,160
LEFLORE,STATE QUESTION NO. 794 LEGISLATIVE REFERENDUM NO. 371,FOR THE PROPOSAL - YES,400104,6,5,80,91
LEFLORE,STATE QUESTION NO. 794 LEGISLATIVE REFERENDUM NO. 371,AGAINST THE PROPOSAL - NO,400104,0,6,28,34
LEFLORE,STATE QUESTION NO. 794 LEGISLATIVE REFERENDUM NO. 371,FOR THE PROPOSAL - YES,400105,5,8,328,341
LEFLORE,STATE QUESTION NO. 794 LEGISLATIVE REFERENDUM NO. 371,AGAINST THE PROPOSAL - NO,400105,2,12,137,151
LEFLORE,STATE QUESTION NO. 794 LEGISLATIVE REFERENDUM NO. 371,FOR THE PROPOSAL - YES,400106,11,12,289,312
LEFLORE,STATE QUESTION NO. 794 LEGISLATIVE REFERENDUM NO. 371,AGAINST THE PROPOSAL - NO,400106,1,4,127,132
LEFLORE,STATE QUESTION NO. 794 LEGISLATIVE REFERENDUM NO. 371,FOR THE PROPOSAL - YES,400107,5,30,442,477
LEFLORE,STATE QUESTION NO. 794 LEGISLATIVE REFERENDUM NO. 371,AGAINST THE PROPOSAL - NO,400107,6,9,181,196
LEFLORE,STATE QUESTION NO. 794 LEGISLATIVE REFERENDUM NO. 371,FOR THE PROPOSAL - YES,400108,0,9,234,243
LEFLORE,STATE QUESTION NO. 794 LEGISLATIVE REFERENDUM NO. 371,AGAINST THE PROPOSAL - NO,400108,2,4,66,72
LEFLORE,STATE QUESTION NO. 794 LEGISLATIVE REFERENDUM NO. 371,FOR THE PROPOSAL - YES,400109,9,48,318,375
LEFLORE,STATE QUESTION NO. 794 LEGISLATIVE REFERENDUM NO. 371,AGAINST THE PROPOSAL - NO,400109,3,18,145,166
LEFLORE,STATE QUESTION NO. 794 LEGISLATIVE REFERENDUM NO. 371,FOR THE PROPOSAL - YES,400110,3,21,225,249
LEFLORE,STATE QUESTION NO. 794 LEGISLATIVE REFERENDUM NO. 371,AGAINST THE PROPOSAL - NO,400110,1,14,124,139
LEFLORE,STATE QUESTION NO. 794 LEGISLATIVE REFERENDUM NO. 371,FOR THE PROPOSAL - YES,400111,0,35,282,317
LEFLORE,STATE QUESTION NO. 794 LEGISLATIVE REFERENDUM NO. 371,AGAINST THE PROPOSAL - NO,400111,1,21,131,153
LEFLORE,STATE QUESTION NO. 794 LEGISLATIVE REFERENDUM NO. 371,FOR THE PROPOSAL - YES,400112,3,3,78,84
LEFLORE,STATE QUESTION NO. 794 LEGISLATIVE REFERENDUM NO. 371,AGAINST THE PROPOSAL - NO,400112,0,0,20,20
LEFLORE,STATE QUESTION NO. 794 LEGISLATIVE REFERENDUM NO. 371,FOR THE PROPOSAL - YES,400113,7,12,149,168
LEFLORE,STATE QUESTION NO. 794 LEGISLATIVE REFERENDUM NO. 371,AGAINST THE PROPOSAL - NO,400113,0,9,74,83
LEFLORE,STATE QUESTION NO. 794 LEGISLATIVE REFERENDUM NO. 371,FOR THE PROPOSAL - YES,400114,1,6,86,93
LEFLORE,STATE QUESTION NO. 794 LEGISLATIVE REFERENDUM NO. 371,AGAINST THE PROPOSAL - NO,400114,0,1,25,26
LEFLORE,STATE QUESTION NO. 794 LEGISLATIVE REFERENDUM NO. 371,FOR THE PROPOSAL - YES,400201,2,5,46,53
LEFLORE,STATE QUESTION NO. 794 LEGISLATIVE REFERENDUM NO. 371,AGAINST THE PROPOSAL - NO,400201,2,1,22,25
LEFLORE,STATE QUESTION NO. 794 LEGISLATIVE REFERENDUM NO. 371,FOR THE PROPOSAL - YES,400202,3,4,89,96
LEFLORE,STATE QUESTION NO. 794 LEGISLATIVE REFERENDUM NO. 371,AGAINST THE PROPOSAL - NO,400202,1,3,38,42
LEFLORE,STATE QUESTION NO. 794 LEGISLATIVE REFERENDUM NO. 371,FOR THE PROPOSAL - YES,400203,23,157,511,691
LEFLORE,STATE QUESTION NO. 794 LEGISLATIVE REFERENDUM NO. 371,AGAINST THE PROPOSAL - NO,400203,8,77,231,316
LEFLORE,STATE QUESTION NO. 794 LEGISLATIVE REFERENDUM NO. 371,FOR THE PROPOSAL - YES,400204,9,76,323,408
LEFLORE,STATE QUESTION NO. 794 LEGISLATIVE REFERENDUM NO. 371,AGAINST THE PROPOSAL - NO,400204,5,22,134,161
LEFLORE,STATE QUESTION NO. 794 LEGISLATIVE REFERENDUM NO. 371,FOR THE PROPOSAL - YES,400205,7,30,127,164
LEFLORE,STATE QUESTION NO. 794 LEGISLATIVE REFERENDUM NO. 371,AGAINST THE PROPOSAL - NO,400205,0,11,66,77
LEFLORE,STATE QUESTION NO. 794 LEGISLATIVE REFERENDUM NO. 371,FOR THE PROPOSAL - YES,400207,8,57,299,364
LEFLORE,STATE QUESTION NO. 794 LEGISLATIVE REFERENDUM NO. 371,AGAINST THE PROPOSAL - NO,400207,1,34,149,184
LEFLORE,STATE QUESTION NO. 794 LEGISLATIVE REFERENDUM NO. 371,FOR THE PROPOSAL - YES,400208,6,49,244,299
LEFLORE,STATE QUESTION NO. 794 LEGISLATIVE REFERENDUM NO. 371,AGAINST THE PROPOSAL - NO,400208,5,24,104,133
LEFLORE,STATE QUESTION NO. 794 LEGISLATIVE REFERENDUM NO. 371,FOR THE PROPOSAL - YES,400210,8,50,304,362
LEFLORE,STATE QUESTION NO. 794 LEGISLATIVE REFERENDUM NO. 371,AGAINST THE PROPOSAL - NO,400210,6,27,148,181
LEFLORE,STATE QUESTION NO. 794 LEGISLATIVE REFERENDUM NO. 371,FOR THE PROPOSAL - YES,400211,4,24,281,309
LEFLORE,STATE QUESTION NO. 794 LEGISLATIVE REFERENDUM NO. 371,AGAINST THE PROPOSAL - NO,400211,0,24,134,158
LEFLORE,STATE QUESTION NO. 794 LEGISLATIVE REFERENDUM NO. 371,FOR THE PROPOSAL - YES,400212,16,74,351,441
LEFLORE,STATE QUESTION NO. 794 LEGISLATIVE REFERENDUM NO. 371,AGAINST THE PROPOSAL - NO,400212,12,32,197,241
LEFLORE,STATE QUESTION NO. 794 LEGISLATIVE REFERENDUM NO. 371,FOR THE PROPOSAL - YES,400213,0,3,32,35
LEFLORE,STATE QUESTION NO. 794 LEGISLATIVE REFERENDUM NO. 371,AGAINST THE PROPOSAL - NO,400213,1,1,19,21
LEFLORE,STATE QUESTION NO. 794 LEGISLATIVE REFERENDUM NO. 371,FOR THE PROPOSAL - YES,400214,5,4,53,62
LEFLORE,STATE QUESTION NO. 794 LEGISLATIVE REFERENDUM NO. 371,AGAINST THE PROPOSAL - NO,400214,2,3,30,35
LEFLORE,STATE QUESTION NO. 794 LEGISLATIVE REFERENDUM NO. 371,FOR THE PROPOSAL - YES,400215,6,13,118,137
LEFLORE,STATE QUESTION NO. 794 LEGISLATIVE REFERENDUM NO. 371,AGAINST THE PROPOSAL - NO,400215,1,2,54,57
LEFLORE,STATE QUESTION NO. 794 LEGISLATIVE REFERENDUM NO. 371,FOR THE PROPOSAL - YES,400301,9,1,195,205
LEFLORE,STATE QUESTION NO. 794 LEGISLATIVE REFERENDUM NO. 371,AGAINST THE PROPOSAL - NO,400301,1,0,50,51
LEFLORE,STATE QUESTION NO. 794 LEGISLATIVE REFERENDUM NO. 371,FOR THE PROPOSAL - YES,400302,11,5,256,272
LEFLORE,STATE QUESTION NO. 794 LEGISLATIVE REFERENDUM NO. 371,AGAINST THE PROPOSAL - NO,400302,2,1,106,109
LEFLORE,STATE QUESTION NO. 794 LEGISLATIVE REFERENDUM NO. 371,FOR THE PROPOSAL - YES,400303,6,1,82,89
LEFLORE,STATE QUESTION NO. 794 LEGISLATIVE REFERENDUM NO. 371,AGAINST THE PROPOSAL - NO,400303,0,0,54,54
LEFLORE,STATE QUESTION NO. 794 LEGISLATIVE REFERENDUM NO. 371,FOR THE PROPOSAL - YES,400304,9,0,107,116
LEFLORE,STATE QUESTION NO. 794 LEGISLATIVE REFERENDUM NO. 371,AGAINST THE PROPOSAL - NO,400304,0,0,38,38
LEFLORE,STATE QUESTION NO. 794 LEGISLATIVE REFERENDUM NO. 371,FOR THE PROPOSAL - YES,400305,2,5,77,84
LEFLORE,STATE QUESTION NO. 794 LEGISLATIVE REFERENDUM NO. 371,AGAINST THE PROPOSAL - NO,400305,0,2,35,37
LEFLORE,STATE QUESTION NO. 794 LEGISLATIVE REFERENDUM NO. 371,FOR THE PROPOSAL - YES,400306,2,4,42,48
LEFLORE,STATE QUESTION NO. 794 LEGISLATIVE REFERENDUM NO. 371,AGAINST THE PROPOSAL - NO,400306,0,3,18,21
LEFLORE,STATE QUESTION NO. 794 LEGISLATIVE REFERENDUM NO. 371,FOR THE PROPOSAL - YES,400309,2,2,50,54
LEFLORE,STATE QUESTION NO. 794 LEGISLATIVE REFERENDUM NO. 371,AGAINST THE PROPOSAL - NO,400309,1,2,17,20
LEFLORE,STATE QUESTION NO. 794 LEGISLATIVE REFERENDUM NO. 371,FOR THE PROPOSAL - YES,400310,7,32,287,326
LEFLORE,STATE QUESTION NO. 794 LEGISLATIVE REFERENDUM NO. 371,AGAINST THE PROPOSAL - NO,400310,5,11,159,175
LEFLORE,STATE QUESTION NO. 794 LEGISLATIVE REFERENDUM NO. 371,FOR THE PROPOSAL - YES,400311,12,19,212,243
LEFLORE,STATE QUESTION NO. 794 LEGISLATIVE REFERENDUM NO. 371,AGAINST THE PROPOSAL - NO,400311,1,1,104,106
LEFLORE,STATE QUESTION NO. 794 LEGISLATIVE REFERENDUM NO. 371,FOR THE PROPOSAL - YES,400312,4,10,139,153
LEFLORE,STATE QUESTION NO. 794 LEGISLATIVE REFERENDUM NO. 371,AGAINST THE PROPOSAL - NO,400312,2,6,77,85
LINCOLN,STATE QUESTION NO. 794 LEGISLATIVE REFERENDUM NO. 371,FOR THE PROPOSAL - YES,410001,19,20,337,376
LINCOLN,STATE QUESTION NO. 794 LEGISLATIVE REFERENDUM NO. 371,AGAINST THE PROPOSAL - NO,410001,5,7,93,105
LINCOLN,STATE QUESTION NO. 794 LEGISLATIVE REFERENDUM NO. 371,FOR THE PROPOSAL - YES,410002,16,23,475,514
LINCOLN,STATE QUESTION NO. 794 LEGISLATIVE REFERENDUM NO. 371,AGAINST THE PROPOSAL - NO,410002,2,4,114,120
LINCOLN,STATE QUESTION NO. 794 LEGISLATIVE REFERENDUM NO. 371,FOR THE PROPOSAL - YES,410003,22,57,521,600
LINCOLN,STATE QUESTION NO. 794 LEGISLATIVE REFERENDUM NO. 371,AGAINST THE PROPOSAL - NO,410003,3,14,119,136
LINCOLN,STATE QUESTION NO. 794 LEGISLATIVE REFERENDUM NO. 371,FOR THE PROPOSAL - YES,410004,13,7,248,268
LINCOLN,STATE QUESTION NO. 794 LEGISLATIVE REFERENDUM NO. 371,AGAINST THE PROPOSAL - NO,410004,1,1,50,52
LINCOLN,STATE QUESTION NO. 794 LEGISLATIVE REFERENDUM NO. 371,FOR THE PROPOSAL - YES,410005,8,25,361,394
LINCOLN,STATE QUESTION NO. 794 LEGISLATIVE REFERENDUM NO. 371,AGAINST THE PROPOSAL - NO,410005,3,7,90,100
LINCOLN,STATE QUESTION NO. 794 LEGISLATIVE REFERENDUM NO. 371,FOR THE PROPOSAL - YES,410006,6,9,163,178
LINCOLN,STATE QUESTION NO. 794 LEGISLATIVE REFERENDUM NO. 371,AGAINST THE PROPOSAL - NO,410006,0,0,46,46
LINCOLN,STATE QUESTION NO. 794 LEGISLATIVE REFERENDUM NO. 371,FOR THE PROPOSAL - YES,410007,8,10,228,246
LINCOLN,STATE QUESTION NO. 794 LEGISLATIVE REFERENDUM NO. 371,AGAINST THE PROPOSAL - NO,410007,4,1,43,48
LINCOLN,STATE QUESTION NO. 794 LEGISLATIVE REFERENDUM NO. 371,FOR THE PROPOSAL - YES,410008,31,35,615,681
LINCOLN,STATE QUESTION NO. 794 LEGISLATIVE REFERENDUM NO. 371,AGAINST THE PROPOSAL - NO,410008,6,11,142,159
LINCOLN,STATE QUESTION NO. 794 LEGISLATIVE REFERENDUM NO. 371,FOR THE PROPOSAL - YES,410009,17,45,333,395
LINCOLN,STATE QUESTION NO. 794 LEGISLATIVE REFERENDUM NO. 371,AGAINST THE PROPOSAL - NO,410009,5,9,71,85
LINCOLN,STATE QUESTION NO. 794 LEGISLATIVE REFERENDUM NO. 371,FOR THE PROPOSAL - YES,410010,17,128,446,591
LINCOLN,STATE QUESTION NO. 794 LEGISLATIVE REFERENDUM NO. 371,AGAINST THE PROPOSAL - NO,410010,2,28,84,114
LINCOLN,STATE QUESTION NO. 794 LEGISLATIVE REFERENDUM NO. 371,FOR THE PROPOSAL - YES,410011,20,97,379,496
LINCOLN,STATE QUESTION NO. 794 LEGISLATIVE REFERENDUM NO. 371,AGAINST THE PROPOSAL - NO,410011,4,18,96,118
LINCOLN,STATE QUESTION NO. 794 LEGISLATIVE REFERENDUM NO. 371,FOR THE PROPOSAL - YES,410012,10,79,359,448
LINCOLN,STATE QUESTION NO. 794 LEGISLATIVE REFERENDUM NO. 371,AGAINST THE PROPOSAL - NO,410012,2,18,84,104
LINCOLN,STATE QUESTION NO. 794 LEGISLATIVE REFERENDUM NO. 371,FOR THE PROPOSAL - YES,410013,8,5,154,167
LINCOLN,STATE QUESTION NO. 794 LEGISLATIVE REFERENDUM NO. 371,AGAINST THE PROPOSAL - NO,410013,2,1,40,43
LINCOLN,STATE QUESTION NO. 794 LEGISLATIVE REFERENDUM NO. 371,FOR THE PROPOSAL - YES,410015,28,21,647,696
LINCOLN,STATE QUESTION NO. 794 LEGISLATIVE REFERENDUM NO. 371,AGAINST THE PROPOSAL - NO,410015,5,3,162,170
LINCOLN,STATE QUESTION NO. 794 LEGISLATIVE REFERENDUM NO. 371,FOR THE PROPOSAL - YES,410016,18,30,435,483
LINCOLN,STATE QUESTION NO. 794 LEGISLATIVE REFERENDUM NO. 371,AGAINST THE PROPOSAL - NO,410016,7,7,115,129
LINCOLN,STATE QUESTION NO. 794 LEGISLATIVE REFERENDUM NO. 371,FOR THE PROPOSAL - YES,410017,9,16,126,151
LINCOLN,STATE QUESTION NO. 794 LEGISLATIVE REFERENDUM NO. 371,AGAINST THE PROPOSAL - NO,410017,3,4,34,41
LINCOLN,STATE QUESTION NO. 794 LEGISLATIVE REFERENDUM NO. 371,FOR THE PROPOSAL - YES,410018,14,25,275,314
LINCOLN,STATE QUESTION NO. 794 LEGISLATIVE REFERENDUM NO. 371,AGAINST THE PROPOSAL - NO,410018,3,6,72,81
LINCOLN,STATE QUESTION NO. 794 LEGISLATIVE REFERENDUM NO. 371,FOR THE PROPOSAL - YES,410019,13,17,423,453
LINCOLN,STATE QUESTION NO. 794 LEGISLATIVE REFERENDUM NO. 371,AGAINST THE PROPOSAL - NO,410019,4,1,102,107
LINCOLN,STATE QUESTION NO. 794 LEGISLATIVE REFERENDUM NO. 371,FOR THE PROPOSAL - YES,410020,5,6,355,366
LINCOLN,STATE QUESTION NO. 794 LEGISLATIVE REFERENDUM NO. 371,AGAINST THE PROPOSAL - NO,410020,3,9,62,74
LINCOLN,STATE QUESTION NO. 794 LEGISLATIVE REFERENDUM NO. 371,FOR THE PROPOSAL - YES,410021,27,16,537,580
LINCOLN,STATE QUESTION NO. 794 LEGISLATIVE REFERENDUM NO. 371,AGAINST THE PROPOSAL - NO,410021,7,1,142,150
LINCOLN,STATE QUESTION NO. 794 LEGISLATIVE REFERENDUM NO. 371,FOR THE PROPOSAL - YES,410022,10,13,582,605
LINCOLN,STATE QUESTION NO. 794 LEGISLATIVE REFERENDUM NO. 371,AGAINST THE PROPOSAL - NO,410022,5,2,118,125
LOGAN,STATE QUESTION NO. 794 LEGISLATIVE REFERENDUM NO. 371,FOR THE PROPOSAL - YES,420101,41,37,368,446
LOGAN,STATE QUESTION NO. 794 LEGISLATIVE REFERENDUM NO. 371,AGAINST THE PROPOSAL - NO,420101,15,6,118,139
LOGAN,STATE QUESTION NO. 794 LEGISLATIVE REFERENDUM NO. 371,FOR THE PROPOSAL - YES,420102,37,75,466,578
LOGAN,STATE QUESTION NO. 794 LEGISLATIVE REFERENDUM NO. 371,AGAINST THE PROPOSAL - NO,420102,8,17,96,121
LOGAN,STATE QUESTION NO. 794 LEGISLATIVE REFERENDUM NO. 371,FOR THE PROPOSAL - YES,420103,134,152,1144,1430
LOGAN,STATE QUESTION NO. 794 LEGISLATIVE REFERENDUM NO. 371,AGAINST THE PROPOSAL - NO,420103,49,27,345,421
LOGAN,STATE QUESTION NO. 794 LEGISLATIVE REFERENDUM NO. 371,FOR THE PROPOSAL - YES,420104,107,130,677,914
LOGAN,STATE QUESTION NO. 794 LEGISLATIVE REFERENDUM NO. 371,AGAINST THE PROPOSAL - NO,420104,19,20,195,234
LOGAN,STATE QUESTION NO. 794 LEGISLATIVE REFERENDUM NO. 371,FOR THE PROPOSAL - YES,420105,36,57,439,532
LOGAN,STATE QUESTION NO. 794 LEGISLATIVE REFERENDUM NO. 371,AGAINST THE PROPOSAL - NO,420105,7,18,90,115
LOGAN,STATE QUESTION NO. 794 LEGISLATIVE REFERENDUM NO. 371,FOR THE PROPOSAL - YES,420106,97,117,768,982
LOGAN,STATE QUESTION NO. 794 LEGISLATIVE REFERENDUM NO. 371,AGAINST THE PROPOSAL - NO,420106,20,28,209,257
LOGAN,STATE QUESTION NO. 794 LEGISLATIVE REFERENDUM NO. 371,FOR THE PROPOSAL - YES,420201,1,1,87,89
LOGAN,STATE QUESTION NO. 794 LEGISLATIVE REFERENDUM NO. 371,AGAINST THE PROPOSAL - NO,420201,0,0,26,26
LOGAN,STATE QUESTION NO. 794 LEGISLATIVE REFERENDUM NO. 371,FOR THE PROPOSAL - YES,420203,22,16,231,269
LOGAN,STATE QUESTION NO. 794 LEGISLATIVE REFERENDUM NO. 371,AGAINST THE PROPOSAL - NO,420203,4,10,46,60
LOGAN,STATE QUESTION NO. 794 LEGISLATIVE REFERENDUM NO. 371,FOR THE PROPOSAL - YES,420204,28,155,650,833
LOGAN,STATE QUESTION NO. 794 LEGISLATIVE REFERENDUM NO. 371,AGAINST THE PROPOSAL - NO,420204,6,39,145,190
LOGAN,STATE QUESTION NO. 794 LEGISLATIVE REFERENDUM NO. 371,FOR THE PROPOSAL - YES,420205,56,160,857,1073
LOGAN,STATE QUESTION NO. 794 LEGISLATIVE REFERENDUM NO. 371,AGAINST THE PROPOSAL - NO,420205,8,35,196,239
LOGAN,STATE QUESTION NO. 794 LEGISLATIVE REFERENDUM NO. 371,FOR THE PROPOSAL - YES,420206,49,95,734,878
LOGAN,STATE QUESTION NO. 794 LEGISLATIVE REFERENDUM NO. 371,AGAINST THE PROPOSAL - NO,420206,18,20,160,198
LOGAN,STATE QUESTION NO. 794 LEGISLATIVE REFERENDUM NO. 371,FOR THE PROPOSAL - YES,420207,93,103,916,1112
LOGAN,STATE QUESTION NO. 794 LEGISLATIVE REFERENDUM NO. 371,AGAINST THE PROPOSAL - NO,420207,26,20,217,263
LOGAN,STATE QUESTION NO. 794 LEGISLATIVE REFERENDUM NO. 371,FOR THE PROPOSAL - YES,420301,2,5,118,125
LOGAN,STATE QUESTION NO. 794 LEGISLATIVE REFERENDUM NO. 371,AGAINST THE PROPOSAL - NO,420301,2,0,32,34
LOGAN,STATE QUESTION NO. 794 LEGISLATIVE REFERENDUM NO. 371,FOR THE PROPOSAL - YES,420302,1,3,81,85
LOGAN,STATE QUESTION NO. 794 LEGISLATIVE REFERENDUM NO. 371,AGAINST THE PROPOSAL - NO,420302,0,0,17,17
LOGAN,STATE QUESTION NO. 794 LEGISLATIVE REFERENDUM NO. 371,FOR THE PROPOSAL - YES,420303,22,22,744,788
LOGAN,STATE QUESTION NO. 794 LEGISLATIVE REFERENDUM NO. 371,AGAINST THE PROPOSAL - NO,420303,6,4,175,185
LOGAN,STATE QUESTION NO. 794 LEGISLATIVE REFERENDUM NO. 371,FOR THE PROPOSAL - YES,420304,7,9,181,197
LOGAN,STATE QUESTION NO. 794 LEGISLATIVE REFERENDUM NO. 371,AGAINST THE PROPOSAL - NO,420304,0,3,53,56
LOGAN,STATE QUESTION NO. 794 LEGISLATIVE REFERENDUM NO. 371,FOR THE PROPOSAL - YES,420305,19,71,400,490
LOGAN,STATE QUESTION NO. 794 LEGISLATIVE REFERENDUM NO. 371,AGAINST THE PROPOSAL - NO,420305,6,16,101,123
LOGAN,STATE QUESTION NO. 794 LEGISLATIVE REFERENDUM NO. 371,FOR THE PROPOSAL - YES,420306,13,25,173,211
LOGAN,STATE QUESTION NO. 794 LEGISLATIVE REFERENDUM NO. 371,AGAINST THE PROPOSAL - NO,420306,1,4,33,38
LOGAN,STATE QUESTION NO. 794 LEGISLATIVE REFERENDUM NO. 371,FOR THE PROPOSAL - YES,420307,41,81,481,603
LOGAN,STATE QUESTION NO. 794 LEGISLATIVE REFERENDUM NO. 371,AGAINST THE PROPOSAL - NO,420307,13,24,170,207
LOGAN,STATE QUESTION NO. 794 LEGISLATIVE REFERENDUM NO. 371,FOR THE PROPOSAL - YES,420308,20,106,497,623
LOGAN,STATE QUESTION NO. 794 LEGISLATIVE REFERENDUM NO. 371,AGAINST THE PROPOSAL - NO,420308,2,25,127,154
LOGAN,STATE QUESTION NO. 794 LEGISLATIVE REFERENDUM NO. 371,FOR THE PROPOSAL - YES,420309,1,9,30,40
LOGAN,STATE QUESTION NO. 794 LEGISLATIVE REFERENDUM NO. 371,AGAINST THE PROPOSAL - NO,420309,2,1,12,15
LOGAN,STATE QUESTION NO. 794 LEGISLATIVE REFERENDUM NO. 371,FOR THE PROPOSAL - YES,420310,3,5,129,137
LOGAN,STATE QUESTION NO. 794 LEGISLATIVE REFERENDUM NO. 371,AGAINST THE PROPOSAL - NO,420310,3,1,29,33
LOVE,STATE QUESTION NO. 794 LEGISLATIVE REFERENDUM NO. 371,FOR THE PROPOSAL - YES,430101,5,19,166,190
LOVE,STATE QUESTION NO. 794 LEGISLATIVE REFERENDUM NO. 371,AGAINST THE PROPOSAL - NO,430101,2,4,50,56
LOVE,STATE QUESTION NO. 794 LEGISLATIVE REFERENDUM NO. 371,FOR THE PROPOSAL - YES,430102,3,23,171,197
LOVE,STATE QUESTION NO. 794 LEGISLATIVE REFERENDUM NO. 371,AGAINST THE PROPOSAL - NO,430102,1,7,39,47
LOVE,STATE QUESTION NO. 794 LEGISLATIVE REFERENDUM NO. 371,FOR THE PROPOSAL - YES,430103,9,28,315,352
LOVE,STATE QUESTION NO. 794 LEGISLATIVE REFERENDUM NO. 371,AGAINST THE PROPOSAL - NO,430103,1,3,78,82
LOVE,STATE QUESTION NO. 794 LEGISLATIVE REFERENDUM NO. 371,FOR THE PROPOSAL - YES,430204,1,16,153,170
LOVE,STATE QUESTION NO. 794 LEGISLATIVE REFERENDUM NO. 371,AGAINST THE PROPOSAL - NO,430204,1,5,41,47
LOVE,STATE QUESTION NO. 794 LEGISLATIVE REFERENDUM NO. 371,FOR THE PROPOSAL - YES,430205,4,34,264,302
LOVE,STATE QUESTION NO. 794 LEGISLATIVE REFERENDUM NO. 371,AGAINST THE PROPOSAL - NO,430205,4,11,59,74
LOVE,STATE QUESTION NO. 794 LEGISLATIVE REFERENDUM NO. 371,FOR THE PROPOSAL - YES,430206,2,8,101,111
LOVE,STATE QUESTION NO. 794 LEGISLATIVE REFERENDUM NO. 371,AGAINST THE PROPOSAL - NO,430206,0,2,30,32
LOVE,STATE QUESTION NO. 794 LEGISLATIVE REFERENDUM NO. 371,FOR THE PROPOSAL - YES,430207,3,3,27,33
LOVE,STATE QUESTION NO. 794 LEGISLATIVE REFERENDUM NO. 371,AGAINST THE PROPOSAL - NO,430207,0,5,12,17
LOVE,STATE QUESTION NO. 794 LEGISLATIVE REFERENDUM NO. 371,FOR THE PROPOSAL - YES,430208,0,1,33,34
LOVE,STATE QUESTION NO. 794 LEGISLATIVE REFERENDUM NO. 371,AGAINST THE PROPOSAL - NO,430208,0,0,5,5
LOVE,STATE QUESTION NO. 794 LEGISLATIVE REFERENDUM NO. 371,FOR THE PROPOSAL - YES,430310,0,20,187,207
LOVE,STATE QUESTION NO. 794 LEGISLATIVE REFERENDUM NO. 371,AGAINST THE PROPOSAL - NO,430310,2,1,50,53
LOVE,STATE QUESTION NO. 794 LEGISLATIVE REFERENDUM NO. 371,FOR THE PROPOSAL - YES,430311,3,37,201,241
LOVE,STATE QUESTION NO. 794 LEGISLATIVE REFERENDUM NO. 371,AGAINST THE PROPOSAL - NO,430311,5,8,51,64
LOVE,STATE QUESTION NO. 794 LEGISLATIVE REFERENDUM NO. 371,FOR THE PROPOSAL - YES,430312,2,11,178,191
LOVE,STATE QUESTION NO. 794 LEGISLATIVE REFERENDUM NO. 371,AGAINST THE PROPOSAL - NO,430312,2,1,57,60
LOVE,STATE QUESTION NO. 794 LEGISLATIVE REFERENDUM NO. 371,FOR THE PROPOSAL - YES,430313,0,3,76,79
LOVE,STATE QUESTION NO. 794 LEGISLATIVE REFERENDUM NO. 371,AGAINST THE PROPOSAL - NO,430313,1,5,28,34
MCCLAIN,STATE QUESTION NO. 794 LEGISLATIVE REFERENDUM NO. 371,FOR THE PROPOSAL - YES,440001,2,2,163,167
MCCLAIN,STATE QUESTION NO. 794 LEGISLATIVE REFERENDUM NO. 371,AGAINST THE PROPOSAL - NO,440001,1,1,26,28
MCCLAIN,STATE QUESTION NO. 794 LEGISLATIVE REFERENDUM NO. 371,FOR THE PROPOSAL - YES,440002,6,4,156,166
MCCLAIN,STATE QUESTION NO. 794 LEGISLATIVE REFERENDUM NO. 371,AGAINST THE PROPOSAL - NO,440002,2,0,27,29
MCCLAIN,STATE QUESTION NO. 794 LEGISLATIVE REFERENDUM NO. 371,FOR THE PROPOSAL - YES,440003,7,24,137,168
MCCLAIN,STATE QUESTION NO. 794 LEGISLATIVE REFERENDUM NO. 371,AGAINST THE PROPOSAL - NO,440003,1,2,31,34
MCCLAIN,STATE QUESTION NO. 794 LEGISLATIVE REFERENDUM NO. 371,FOR THE PROPOSAL - YES,440004,8,8,221,237
MCCLAIN,STATE QUESTION NO. 794 LEGISLATIVE REFERENDUM NO. 371,AGAINST THE PROPOSAL - NO,440004,1,3,37,41
MCCLAIN,STATE QUESTION NO. 794 LEGISLATIVE REFERENDUM NO. 371,FOR THE PROPOSAL - YES,440005,23,21,363,407
MCCLAIN,STATE QUESTION NO. 794 LEGISLATIVE REFERENDUM NO. 371,AGAINST THE PROPOSAL - NO,440005,12,7,100,119
MCCLAIN,STATE QUESTION NO. 794 LEGISLATIVE REFERENDUM NO. 371,FOR THE PROPOSAL - YES,440006,18,129,502,649
MCCLAIN,STATE QUESTION NO. 794 LEGISLATIVE REFERENDUM NO. 371,AGAINST THE PROPOSAL - NO,440006,9,26,114,149
MCCLAIN,STATE QUESTION NO. 794 LEGISLATIVE REFERENDUM NO. 371,FOR THE PROPOSAL - YES,440007,7,30,214,251
MCCLAIN,STATE QUESTION NO. 794 LEGISLATIVE REFERENDUM NO. 371,AGAINST THE PROPOSAL - NO,440007,1,9,47,57
MCCLAIN,STATE QUESTION NO. 794 LEGISLATIVE REFERENDUM NO. 371,FOR THE PROPOSAL - YES,440008,18,30,449,497
MCCLAIN,STATE QUESTION NO. 794 LEGISLATIVE REFERENDUM NO. 371,AGAINST THE PROPOSAL - NO,440008,10,8,138,156
MCCLAIN,STATE QUESTION NO. 794 LEGISLATIVE REFERENDUM NO. 371,FOR THE PROPOSAL - YES,440009,57,39,560,656
MCCLAIN,STATE QUESTION NO. 794 LEGISLATIVE REFERENDUM NO. 371,AGAINST THE PROPOSAL - NO,440009,11,8,161,180
MCCLAIN,STATE QUESTION NO. 794 LEGISLATIVE REFERENDUM NO. 371,FOR THE PROPOSAL - YES,440010,6,8,127,141
MCCLAIN,STATE QUESTION NO. 794 LEGISLATIVE REFERENDUM NO. 371,AGAINST THE PROPOSAL - NO,440010,2,5,34,41
MCCLAIN,STATE QUESTION NO. 794 LEGISLATIVE REFERENDUM NO. 371,FOR THE PROPOSAL - YES,440011,9,13,240,262
MCCLAIN,STATE QUESTION NO. 794 LEGISLATIVE REFERENDUM NO. 371,AGAINST THE PROPOSAL - NO,440011,3,4,52,59
MCCLAIN,STATE QUESTION NO. 794 LEGISLATIVE REFERENDUM NO. 371,FOR THE PROPOSAL - YES,440012,43,20,749,812
MCCLAIN,STATE QUESTION NO. 794 LEGISLATIVE REFERENDUM NO. 371,AGAINST THE PROPOSAL - NO,440012,10,3,156,169
MCCLAIN,STATE QUESTION NO. 794 LEGISLATIVE REFERENDUM NO. 371,FOR THE PROPOSAL - YES,440013,107,39,1143,1289
MCCLAIN,STATE QUESTION NO. 794 LEGISLATIVE REFERENDUM NO. 371,AGAINST THE PROPOSAL - NO,440013,13,8,327,348
MCCLAIN,STATE QUESTION NO. 794 LEGISLATIVE REFERENDUM NO. 371,FOR THE PROPOSAL - YES,440014,29,4,390,423
MCCLAIN,STATE QUESTION NO. 794 LEGISLATIVE REFERENDUM NO. 371,AGAINST THE PROPOSAL - NO,440014,4,6,88,98
MCCLAIN,STATE QUESTION NO. 794 LEGISLATIVE REFERENDUM NO. 371,FOR THE PROPOSAL - YES,440015,34,16,597,647
MCCLAIN,STATE QUESTION NO. 794 LEGISLATIVE REFERENDUM NO. 371,AGAINST THE PROPOSAL - NO,440015,12,4,153,169
MCCLAIN,STATE QUESTION NO. 794 LEGISLATIVE REFERENDUM NO. 371,FOR THE PROPOSAL - YES,440016,45,25,631,701
MCCLAIN,STATE QUESTION NO. 794 LEGISLATIVE REFERENDUM NO. 371,AGAINST THE PROPOSAL - NO,440016,6,3,157,166
MCCLAIN,STATE QUESTION NO. 794 LEGISLATIVE REFERENDUM NO. 371,FOR THE PROPOSAL - YES,440017,8,5,130,143
MCCLAIN,STATE QUESTION NO. 794 LEGISLATIVE REFERENDUM NO. 371,AGAINST THE PROPOSAL - NO,440017,2,4,26,32
MCCLAIN,STATE QUESTION NO. 794 LEGISLATIVE REFERENDUM NO. 371,FOR THE PROPOSAL - YES,440018,22,8,352,382
MCCLAIN,STATE QUESTION NO. 794 LEGISLATIVE REFERENDUM NO. 371,AGAINST THE PROPOSAL - NO,440018,9,2,93,104
MCCLAIN,STATE QUESTION NO. 794 LEGISLATIVE REFERENDUM NO. 371,FOR THE PROPOSAL - YES,440019,29,16,433,478
MCCLAIN,STATE QUESTION NO. 794 LEGISLATIVE REFERENDUM NO. 371,AGAINST THE PROPOSAL - NO,440019,8,3,107,118
MCCLAIN,STATE QUESTION NO. 794 LEGISLATIVE REFERENDUM NO. 371,FOR THE PROPOSAL - YES,440020,22,18,336,376
MCCLAIN,STATE QUESTION NO. 794 LEGISLATIVE REFERENDUM NO. 371,AGAINST THE PROPOSAL - NO,440020,1,3,96,100
MCCLAIN,STATE QUESTION NO. 794 LEGISLATIVE REFERENDUM NO. 371,FOR THE PROPOSAL - YES,440021,9,47,300,356
MCCLAIN,STATE QUESTION NO. 794 LEGISLATIVE REFERENDUM NO. 371,AGAINST THE PROPOSAL - NO,440021,4,13,84,101
MCCLAIN,STATE QUESTION NO. 794 LEGISLATIVE REFERENDUM NO. 371,FOR THE PROPOSAL - YES,440023,21,56,383,460
MCCLAIN,STATE QUESTION NO. 794 LEGISLATIVE REFERENDUM NO. 371,AGAINST THE PROPOSAL - NO,440023,4,14,82,100
MCCLAIN,STATE QUESTION NO. 794 LEGISLATIVE REFERENDUM NO. 371,FOR THE PROPOSAL - YES,440024,29,50,388,467
MCCLAIN,STATE QUESTION NO. 794 LEGISLATIVE REFERENDUM NO. 371,AGAINST THE PROPOSAL - NO,440024,3,21,123,147
MCCLAIN,STATE QUESTION NO. 794 LEGISLATIVE REFERENDUM NO. 371,FOR THE PROPOSAL - YES,440026,2,22,120,144
MCCLAIN,STATE QUESTION NO. 794 LEGISLATIVE REFERENDUM NO. 371,AGAINST THE PROPOSAL - NO,440026,1,3,32,36
MCCLAIN,STATE QUESTION NO. 794 LEGISLATIVE REFERENDUM NO. 371,FOR THE PROPOSAL - YES,440027,19,0,251,270
MCCLAIN,STATE QUESTION NO. 794 LEGISLATIVE REFERENDUM NO. 371,AGAINST THE PROPOSAL - NO,440027,1,4,61,66
MCCLAIN,STATE QUESTION NO. 794 LEGISLATIVE REFERENDUM NO. 371,FOR THE PROPOSAL - YES,440028,30,24,283,337
MCCLAIN,STATE QUESTION NO. 794 LEGISLATIVE REFERENDUM NO. 371,AGAINST THE PROPOSAL - NO,440028,6,4,59,69
MCCURTAIN,STATE QUESTION NO. 794 LEGISLATIVE REFERENDUM NO. 371,FOR THE PROPOSAL - YES,450002,4,5,79,88
MCCURTAIN,STATE QUESTION NO. 794 LEGISLATIVE REFERENDUM NO. 371,AGAINST THE PROPOSAL - NO,450002,0,3,37,40
MCCURTAIN,STATE QUESTION NO. 794 LEGISLATIVE REFERENDUM NO. 371,FOR THE PROPOSAL - YES,450004,11,59,233,303
MCCURTAIN,STATE QUESTION NO. 794 LEGISLATIVE REFERENDUM NO. 371,AGAINST THE PROPOSAL - NO,450004,4,25,63,92
MCCURTAIN,STATE QUESTION NO. 794 LEGISLATIVE REFERENDUM NO. 371,FOR THE PROPOSAL - YES,450005,1,2,91,94
MCCURTAIN,STATE QUESTION NO. 794 LEGISLATIVE REFERENDUM NO. 371,AGAINST THE PROPOSAL - NO,450005,2,1,22,25
MCCURTAIN,STATE QUESTION NO. 794 LEGISLATIVE REFERENDUM NO. 371,FOR THE PROPOSAL - YES,450006,8,42,217,267
MCCURTAIN,STATE QUESTION NO. 794 LEGISLATIVE REFERENDUM NO. 371,AGAINST THE PROPOSAL - NO,450006,4,16,84,104
MCCURTAIN,STATE QUESTION NO. 794 LEGISLATIVE REFERENDUM NO. 371,FOR THE PROPOSAL - YES,450008,8,33,228,269
MCCURTAIN,STATE QUESTION NO. 794 LEGISLATIVE REFERENDUM NO. 371,AGAINST THE PROPOSAL - NO,450008,2,15,112,129
MCCURTAIN,STATE QUESTION NO. 794 LEGISLATIVE REFERENDUM NO. 371,FOR THE PROPOSAL - YES,450009,8,22,220,250
MCCURTAIN,STATE QUESTION NO. 794 LEGISLATIVE REFERENDUM NO. 371,AGAINST THE PROPOSAL - NO,450009,1,8,97,106
MCCURTAIN,STATE QUESTION NO. 794 LEGISLATIVE REFERENDUM NO. 371,FOR THE PROPOSAL - YES,450011,4,13,59,76
MCCURTAIN,STATE QUESTION NO. 794 LEGISLATIVE REFERENDUM NO. 371,AGAINST THE PROPOSAL - NO,450011,2,7,23,32
MCCURTAIN,STATE QUESTION NO. 794 LEGISLATIVE REFERENDUM NO. 371,FOR THE PROPOSAL - YES,450012,1,3,48,52
MCCURTAIN,STATE QUESTION NO. 794 LEGISLATIVE REFERENDUM NO. 371,AGAINST THE PROPOSAL - NO,450012,0,0,27,27
MCCURTAIN,STATE QUESTION NO. 794 LEGISLATIVE REFERENDUM NO. 371,FOR THE PROPOSAL - YES,450013,7,17,144,168
MCCURTAIN,STATE QUESTION NO. 794 LEGISLATIVE REFERENDUM NO. 371,AGAINST THE PROPOSAL - NO,450013,2,4,69,75
MCCURTAIN,STATE QUESTION NO. 794 LEGISLATIVE REFERENDUM NO. 371,FOR THE PROPOSAL - YES,450014,1,4,80,85
MCCURTAIN,STATE QUESTION NO. 794 LEGISLATIVE REFERENDUM NO. 371,AGAINST THE PROPOSAL - NO,450014,0,2,39,41
MCCURTAIN,STATE QUESTION NO. 794 LEGISLATIVE REFERENDUM NO. 371,FOR THE PROPOSAL - YES,450015,2,8,77,87
MCCURTAIN,STATE QUESTION NO. 794 LEGISLATIVE REFERENDUM NO. 371,AGAINST THE PROPOSAL - NO,450015,0,5,28,33
MCCURTAIN,STATE QUESTION NO. 794 LEGISLATIVE REFERENDUM NO. 371,FOR THE PROPOSAL - YES,450017,2,15,174,191
MCCURTAIN,STATE QUESTION NO. 794 LEGISLATIVE REFERENDUM NO. 371,AGAINST THE PROPOSAL - NO,450017,0,1,71,72
MCCURTAIN,STATE QUESTION NO. 794 LEGISLATIVE REFERENDUM NO. 371,FOR THE PROPOSAL - YES,450018,10,24,329,363
MCCURTAIN,STATE QUESTION NO. 794 LEGISLATIVE REFERENDUM NO. 371,AGAINST THE PROPOSAL - NO,450018,3,4,97,104
MCCURTAIN,STATE QUESTION NO. 794 LEGISLATIVE REFERENDUM NO. 371,FOR THE PROPOSAL - YES,450019,4,10,265,279
MCCURTAIN,STATE QUESTION NO. 794 LEGISLATIVE REFERENDUM NO. 371,AGAINST THE PROPOSAL - NO,450019,1,4,97,102
MCCURTAIN,STATE QUESTION NO. 794 LEGISLATIVE REFERENDUM NO. 371,FOR THE PROPOSAL - YES,450020,0,27,220,247
MCCURTAIN,STATE QUESTION NO. 794 LEGISLATIVE REFERENDUM NO. 371,AGAINST THE PROPOSAL - NO,450020,1,4,58,63
MCCURTAIN,STATE QUESTION NO. 794 LEGISLATIVE REFERENDUM NO. 371,FOR THE PROPOSAL - YES,450022,3,7,156,166
MCCURTAIN,STATE QUESTION NO. 794 LEGISLATIVE REFERENDUM NO. 371,AGAINST THE PROPOSAL - NO,450022,1,1,61,63
MCCURTAIN,STATE QUESTION NO. 794 LEGISLATIVE REFERENDUM NO. 371,FOR THE PROPOSAL - YES,450023,2,10,120,132
MCCURTAIN,STATE QUESTION NO. 794 LEGISLATIVE REFERENDUM NO. 371,AGAINST THE PROPOSAL - NO,450023,2,1,54,57
MCCURTAIN,STATE QUESTION NO. 794 LEGISLATIVE REFERENDUM NO. 371,FOR THE PROPOSAL - YES,450024,2,4,73,79
MCCURTAIN,STATE QUESTION NO. 794 LEGISLATIVE REFERENDUM NO. 371,AGAINST THE PROPOSAL - NO,450024,2,1,36,39
MCCURTAIN,STATE QUESTION NO. 794 LEGISLATIVE REFERENDUM NO. 371,FOR THE PROPOSAL - YES,450025,2,2,110,114
MCCURTAIN,STATE QUESTION NO. 794 LEGISLATIVE REFERENDUM NO. 371,AGAINST THE PROPOSAL - NO,450025,1,2,56,59
MCCURTAIN,STATE QUESTION NO. 794 LEGISLATIVE REFERENDUM NO. 371,FOR THE PROPOSAL - YES,450026,7,4,82,93
MCCURTAIN,STATE QUESTION NO. 794 LEGISLATIVE REFERENDUM NO. 371,AGAINST THE PROPOSAL - NO,450026,1,0,37,38
MCCURTAIN,STATE QUESTION NO. 794 LEGISLATIVE REFERENDUM NO. 371,FOR THE PROPOSAL - YES,450027,1,0,49,50
MCCURTAIN,STATE QUESTION NO. 794 LEGISLATIVE REFERENDUM NO. 371,AGAINST THE PROPOSAL - NO,450027,0,1,26,27
MCCURTAIN,STATE QUESTION NO. 794 LEGISLATIVE REFERENDUM NO. 371,FOR THE PROPOSAL - YES,450028,0,4,33,37
MCCURTAIN,STATE QUESTION NO. 794 LEGISLATIVE REFERENDUM NO. 371,AGAINST THE PROPOSAL - NO,450028,0,1,35,36
MCCURTAIN,STATE QUESTION NO. 794 LEGISLATIVE REFERENDUM NO. 371,FOR THE PROPOSAL - YES,450029,2,3,126,131
MCCURTAIN,STATE QUESTION NO. 794 LEGISLATIVE REFERENDUM NO. 371,AGAINST THE PROPOSAL - NO,450029,2,1,75,78
MCCURTAIN,STATE QUESTION NO. 794 LEGISLATIVE REFERENDUM NO. 371,FOR THE PROPOSAL - YES,450031,13,21,266,300
MCCURTAIN,STATE QUESTION NO. 794 LEGISLATIVE REFERENDUM NO. 371,AGAINST THE PROPOSAL - NO,450031,3,10,104,117
MCCURTAIN,STATE QUESTION NO. 794 LEGISLATIVE REFERENDUM NO. 371,FOR THE PROPOSAL - YES,450033,3,13,130,146
MCCURTAIN,STATE QUESTION NO. 794 LEGISLATIVE REFERENDUM NO. 371,AGAINST THE PROPOSAL - NO,450033,2,4,59,65
MCCURTAIN,STATE QUESTION NO. 794 LEGISLATIVE REFERENDUM NO. 371,FOR THE PROPOSAL - YES,450034,1,14,149,164
MCCURTAIN,STATE QUESTION NO. 794 LEGISLATIVE REFERENDUM NO. 371,AGAINST THE PROPOSAL - NO,450034,1,4,82,87
MCCURTAIN,STATE QUESTION NO. 794 LEGISLATIVE REFERENDUM NO. 371,FOR THE PROPOSAL - YES,450035,6,14,275,295
MCCURTAIN,STATE QUESTION NO. 794 LEGISLATIVE REFERENDUM NO. 371,AGAINST THE PROPOSAL - NO,450035,2,3,146,151
MCCURTAIN,STATE QUESTION NO. 794 LEGISLATIVE REFERENDUM NO. 371,FOR THE PROPOSAL - YES,450036,4,8,206,218
MCCURTAIN,STATE QUESTION NO. 794 LEGISLATIVE REFERENDUM NO. 371,AGAINST THE PROPOSAL - NO,450036,0,6,107,113
MCCURTAIN,STATE QUESTION NO. 794 LEGISLATIVE REFERENDUM NO. 371,FOR THE PROPOSAL - YES,450037,1,4,58,63
MCCURTAIN,STATE QUESTION NO. 794 LEGISLATIVE REFERENDUM NO. 371,AGAINST THE PROPOSAL - NO,450037,0,0,16,16
MCCURTAIN,STATE QUESTION NO. 794 LEGISLATIVE REFERENDUM NO. 371,FOR THE PROPOSAL - YES,450038,2,8,243,253
MCCURTAIN,STATE QUESTION NO. 794 LEGISLATIVE REFERENDUM NO. 371,AGAINST THE PROPOSAL - NO,450038,1,2,108,111
MCINTOSH,STATE QUESTION NO. 794 LEGISLATIVE REFERENDUM NO. 371,FOR THE PROPOSAL - YES,460102,11,22,441,474
MCINTOSH,STATE QUESTION NO. 794 LEGISLATIVE REFERENDUM NO. 371,AGAINST THE PROPOSAL - NO,460102,4,3,115,122
MCINTOSH,STATE QUESTION NO. 794 LEGISLATIVE REFERENDUM NO. 371,FOR THE PROPOSAL - YES,460103,17,51,702,770
MCINTOSH,STATE QUESTION NO. 794 LEGISLATIVE REFERENDUM NO. 371,AGAINST THE PROPOSAL - NO,460103,4,16,172,192
MCINTOSH,STATE QUESTION NO. 794 LEGISLATIVE REFERENDUM NO. 371,FOR THE PROPOSAL - YES,460104,10,23,357,390
MCINTOSH,STATE QUESTION NO. 794 LEGISLATIVE REFERENDUM NO. 371,AGAINST THE PROPOSAL - NO,460104,2,13,84,99
MCINTOSH,STATE QUESTION NO. 794 LEGISLATIVE REFERENDUM NO. 371,FOR THE PROPOSAL - YES,460201,26,123,614,763
MCINTOSH,STATE QUESTION NO. 794 LEGISLATIVE REFERENDUM NO. 371,AGAINST THE PROPOSAL - NO,460201,2,29,130,161
MCINTOSH,STATE QUESTION NO. 794 LEGISLATIVE REFERENDUM NO. 371,FOR THE PROPOSAL - YES,460203,6,56,240,302
MCINTOSH,STATE QUESTION NO. 794 LEGISLATIVE REFERENDUM NO. 371,AGAINST THE PROPOSAL - NO,460203,1,10,55,66
MCINTOSH,STATE QUESTION NO. 794 LEGISLATIVE REFERENDUM NO. 371,FOR THE PROPOSAL - YES,460205,45,117,732,894
MCINTOSH,STATE QUESTION NO. 794 LEGISLATIVE REFERENDUM NO. 371,AGAINST THE PROPOSAL - NO,460205,15,23,131,169
MCINTOSH,STATE QUESTION NO. 794 LEGISLATIVE REFERENDUM NO. 371,FOR THE PROPOSAL - YES,460307,2,35,277,314
MCINTOSH,STATE QUESTION NO. 794 LEGISLATIVE REFERENDUM NO. 371,AGAINST THE PROPOSAL - NO,460307,2,7,72,81
MCINTOSH,STATE QUESTION NO. 794 LEGISLATIVE REFERENDUM NO. 371,FOR THE PROPOSAL - YES,460310,0,4,111,115
MCINTOSH,STATE QUESTION NO. 794 LEGISLATIVE REFERENDUM NO. 371,AGAINST THE PROPOSAL - NO,460310,4,1,35,40
MCINTOSH,STATE QUESTION NO. 794 LEGISLATIVE REFERENDUM NO. 371,FOR THE PROPOSAL - YES,460311,4,17,140,161
MCINTOSH,STATE QUESTION NO. 794 LEGISLATIVE REFERENDUM NO. 371,AGAINST THE PROPOSAL - NO,460311,1,2,43,46
MCINTOSH,STATE QUESTION NO. 794 LEGISLATIVE REFERENDUM NO. 371,FOR THE PROPOSAL - YES,460312,0,0,47,47
MCINTOSH,STATE QUESTION NO. 794 LEGISLATIVE REFERENDUM NO. 371,AGAINST THE PROPOSAL - NO,460312,0,0,25,25
MCINTOSH,STATE QUESTION NO. 794 LEGISLATIVE REFERENDUM NO. 371,FOR THE PROPOSAL - YES,460313,3,0,71,74
MCINTOSH,STATE QUESTION NO. 794 LEGISLATIVE REFERENDUM NO. 371,AGAINST THE PROPOSAL - NO,460313,1,1,18,20
MCINTOSH,STATE QUESTION NO. 794 LEGISLATIVE REFERENDUM NO. 371,FOR THE PROPOSAL - YES,460314,27,49,427,503
MCINTOSH,STATE QUESTION NO. 794 LEGISLATIVE REFERENDUM NO. 371,AGAINST THE PROPOSAL - NO,460314,2,13,116,131
MCINTOSH,STATE QUESTION NO. 794 LEGISLATIVE REFERENDUM NO. 371,FOR THE PROPOSAL - YES,460315,3,2,144,149
MCINTOSH,STATE QUESTION NO. 794 LEGISLATIVE REFERENDUM NO. 371,AGAINST THE PROPOSAL - NO,460315,2,1,31,34
MCINTOSH,STATE QUESTION NO. 794 LEGISLATIVE REFERENDUM NO. 371,FOR THE PROPOSAL - YES,460316,10,11,232,253
MCINTOSH,STATE QUESTION NO. 794 LEGISLATIVE REFERENDUM NO. 371,AGAINST THE PROPOSAL - NO,460316,2,7,52,61
MAJOR,STATE QUESTION NO. 794 LEGISLATIVE REFERENDUM NO. 371,FOR THE PROPOSAL - YES,470002,18,32,460,510
MAJOR,STATE QUESTION NO. 794 LEGISLATIVE REFERENDUM NO. 371,AGAINST THE PROPOSAL - NO,470002,3,11,114,128
MAJOR,STATE QUESTION NO. 794 LEGISLATIVE REFERENDUM NO. 371,FOR THE PROPOSAL - YES,470004,2,6,110,118
MAJOR,STATE QUESTION NO. 794 LEGISLATIVE REFERENDUM NO. 371,AGAINST THE PROPOSAL - NO,470004,0,4,20,24
MAJOR,STATE QUESTION NO. 794 LEGISLATIVE REFERENDUM NO. 371,FOR THE PROPOSAL - YES,470009,2,3,38,43
MAJOR,STATE QUESTION NO. 794 LEGISLATIVE REFERENDUM NO. 371,AGAINST THE PROPOSAL - NO,470009,1,1,5,7
MAJOR,STATE QUESTION NO. 794 LEGISLATIVE REFERENDUM NO. 371,FOR THE PROPOSAL - YES,470010,6,6,144,156
MAJOR,STATE QUESTION NO. 794 LEGISLATIVE REFERENDUM NO. 371,AGAINST THE PROPOSAL - NO,470010,1,0,40,41
MAJOR,STATE QUESTION NO. 794 LEGISLATIVE REFERENDUM NO. 371,FOR THE PROPOSAL - YES,470015,0,8,144,152
MAJOR,STATE QUESTION NO. 794 LEGISLATIVE REFERENDUM NO. 371,AGAINST THE PROPOSAL - NO,470015,0,2,40,42
MAJOR,STATE QUESTION NO. 794 LEGISLATIVE REFERENDUM NO. 371,FOR THE PROPOSAL - YES,470016,3,2,55,60
MAJOR,STATE QUESTION NO. 794 LEGISLATIVE REFERENDUM NO. 371,AGAINST THE PROPOSAL - NO,470016,0,0,14,14
MAJOR,STATE QUESTION NO. 794 LEGISLATIVE REFERENDUM NO. 371,FOR THE PROPOSAL - YES,470020,35,74,520,629
MAJOR,STATE QUESTION NO. 794 LEGISLATIVE REFERENDUM NO. 371,AGAINST THE PROPOSAL - NO,470020,9,21,134,164
MAJOR,STATE QUESTION NO. 794 LEGISLATIVE REFERENDUM NO. 371,FOR THE PROPOSAL - YES,470022,22,104,386,512
MAJOR,STATE QUESTION NO. 794 LEGISLATIVE REFERENDUM NO. 371,AGAINST THE PROPOSAL - NO,470022,4,26,87,117
MARSHALL,STATE QUESTION NO. 794 LEGISLATIVE REFERENDUM NO. 371,FOR THE PROPOSAL - YES,480101,15,55,294,364
MARSHALL,STATE QUESTION NO. 794 LEGISLATIVE REFERENDUM NO. 371,AGAINST THE PROPOSAL - NO,480101,0,26,150,176
MARSHALL,STATE QUESTION NO. 794 LEGISLATIVE REFERENDUM NO. 371,FOR THE PROPOSAL - YES,480102,6,27,174,207
MARSHALL,STATE QUESTION NO. 794 LEGISLATIVE REFERENDUM NO. 371,AGAINST THE PROPOSAL - NO,480102,1,10,69,80
MARSHALL,STATE QUESTION NO. 794 LEGISLATIVE REFERENDUM NO. 371,FOR THE PROPOSAL - YES,480105,10,25,194,229
MARSHALL,STATE QUESTION NO. 794 LEGISLATIVE REFERENDUM NO. 371,AGAINST THE PROPOSAL - NO,480105,2,10,62,74
MARSHALL,STATE QUESTION NO. 794 LEGISLATIVE REFERENDUM NO. 371,FOR THE PROPOSAL - YES,480106,1,19,136,156
MARSHALL,STATE QUESTION NO. 794 LEGISLATIVE REFERENDUM NO. 371,AGAINST THE PROPOSAL - NO,480106,0,4,41,45
MARSHALL,STATE QUESTION NO. 794 LEGISLATIVE REFERENDUM NO. 371,FOR THE PROPOSAL - YES,480201,2,16,143,161
MARSHALL,STATE QUESTION NO. 794 LEGISLATIVE REFERENDUM NO. 371,AGAINST THE PROPOSAL - NO,480201,1,7,68,76
MARSHALL,STATE QUESTION NO. 794 LEGISLATIVE REFERENDUM NO. 371,FOR THE PROPOSAL - YES,480202,5,33,156,194
MARSHALL,STATE QUESTION NO. 794 LEGISLATIVE REFERENDUM NO. 371,AGAINST THE PROPOSAL - NO,480202,2,11,44,57
MARSHALL,STATE QUESTION NO. 794 LEGISLATIVE REFERENDUM NO. 371,FOR THE PROPOSAL - YES,480204,10,28,279,317
MARSHALL,STATE QUESTION NO. 794 LEGISLATIVE REFERENDUM NO. 371,AGAINST THE PROPOSAL - NO,480204,3,19,74,96
MARSHALL,STATE QUESTION NO. 794 LEGISLATIVE REFERENDUM NO. 371,FOR THE PROPOSAL - YES,480206,10,18,193,221
MARSHALL,STATE QUESTION NO. 794 LEGISLATIVE REFERENDUM NO. 371,AGAINST THE PROPOSAL - NO,480206,0,6,62,68
MARSHALL,STATE QUESTION NO. 794 LEGISLATIVE REFERENDUM NO. 371,FOR THE PROPOSAL - YES,480302,9,31,247,287
MARSHALL,STATE QUESTION NO. 794 LEGISLATIVE REFERENDUM NO. 371,AGAINST THE PROPOSAL - NO,480302,0,10,57,67
MARSHALL,STATE QUESTION NO. 794 LEGISLATIVE REFERENDUM NO. 371,FOR THE PROPOSAL - YES,480303,25,58,394,477
MARSHALL,STATE QUESTION NO. 794 LEGISLATIVE REFERENDUM NO. 371,AGAINST THE PROPOSAL - NO,480303,1,27,104,132
MARSHALL,STATE QUESTION NO. 794 LEGISLATIVE REFERENDUM NO. 371,FOR THE PROPOSAL - YES,480304,19,69,540,628
MARSHALL,STATE QUESTION NO. 794 LEGISLATIVE REFERENDUM NO. 371,AGAINST THE PROPOSAL - NO,480304,13,29,140,182
MAYES,STATE QUESTION NO. 794 LEGISLATIVE REFERENDUM NO. 371,FOR THE PROPOSAL - YES,490011,14,26,362,402
MAYES,STATE QUESTION NO. 794 LEGISLATIVE REFERENDUM NO. 371,AGAINST THE PROPOSAL - NO,490011,5,10,122,137
MAYES,STATE QUESTION NO. 794 LEGISLATIVE REFERENDUM NO. 371,FOR THE PROPOSAL - YES,490012,12,26,371,409
MAYES,STATE QUESTION NO. 794 LEGISLATIVE REFERENDUM NO. 371,AGAINST THE PROPOSAL - NO,490012,4,6,102,112
MAYES,STATE QUESTION NO. 794 LEGISLATIVE REFERENDUM NO. 371,FOR THE PROPOSAL - YES,490014,0,9,135,144
MAYES,STATE QUESTION NO. 794 LEGISLATIVE REFERENDUM NO. 371,AGAINST THE PROPOSAL - NO,490014,2,1,29,32
MAYES,STATE QUESTION NO. 794 LEGISLATIVE REFERENDUM NO. 371,FOR THE PROPOSAL - YES,490015,18,49,323,390
MAYES,STATE QUESTION NO. 794 LEGISLATIVE REFERENDUM NO. 371,AGAINST THE PROPOSAL - NO,490015,1,10,56,67
MAYES,STATE QUESTION NO. 794 LEGISLATIVE REFERENDUM NO. 371,FOR THE PROPOSAL - YES,490016,11,34,249,294
MAYES,STATE QUESTION NO. 794 LEGISLATIVE REFERENDUM NO. 371,AGAINST THE PROPOSAL - NO,490016,3,2,57,62
MAYES,STATE QUESTION NO. 794 LEGISLATIVE REFERENDUM NO. 371,FOR THE PROPOSAL - YES,490020,24,84,520,628
MAYES,STATE QUESTION NO. 794 LEGISLATIVE REFERENDUM NO. 371,AGAINST THE PROPOSAL - NO,490020,3,20,113,136
MAYES,STATE QUESTION NO. 794 LEGISLATIVE REFERENDUM NO. 371,FOR THE PROPOSAL - YES,490021,14,28,258,300
MAYES,STATE QUESTION NO. 794 LEGISLATIVE REFERENDUM NO. 371,AGAINST THE PROPOSAL - NO,490021,0,5,46,51
MAYES,STATE QUESTION NO. 794 LEGISLATIVE REFERENDUM NO. 371,FOR THE PROPOSAL - YES,490022,5,22,340,367
MAYES,STATE QUESTION NO. 794 LEGISLATIVE REFERENDUM NO. 371,AGAINST THE PROPOSAL - NO,490022,3,2,81,86
MAYES,STATE QUESTION NO. 794 LEGISLATIVE REFERENDUM NO. 371,FOR THE PROPOSAL - YES,490023,10,37,478,525
MAYES,STATE QUESTION NO. 794 LEGISLATIVE REFERENDUM NO. 371,AGAINST THE PROPOSAL - NO,490023,6,10,90,106
MAYES,STATE QUESTION NO. 794 LEGISLATIVE REFERENDUM NO. 371,FOR THE PROPOSAL - YES,490024,8,15,304,327
MAYES,STATE QUESTION NO. 794 LEGISLATIVE REFERENDUM NO. 371,AGAINST THE PROPOSAL - NO,490024,1,2,78,81
MAYES,STATE QUESTION NO. 794 LEGISLATIVE REFERENDUM NO. 371,FOR THE PROPOSAL - YES,490025,5,17,230,252
MAYES,STATE QUESTION NO. 794 LEGISLATIVE REFERENDUM NO. 371,AGAINST THE PROPOSAL - NO,490025,4,2,77,83
MAYES,STATE QUESTION NO. 794 LEGISLATIVE REFERENDUM NO. 371,FOR THE PROPOSAL - YES,490026,2,0,33,35
MAYES,STATE QUESTION NO. 794 LEGISLATIVE REFERENDUM NO. 371,AGAINST THE PROPOSAL - NO,490026,0,0,12,12
MAYES,STATE QUESTION NO. 794 LEGISLATIVE REFERENDUM NO. 371,FOR THE PROPOSAL - YES,490027,0,0,42,42
MAYES,STATE QUESTION NO. 794 LEGISLATIVE REFERENDUM NO. 371,AGAINST THE PROPOSAL - NO,490027,0,0,11,11
MAYES,STATE QUESTION NO. 794 LEGISLATIVE REFERENDUM NO. 371,FOR THE PROPOSAL - YES,490031,24,16,571,611
MAYES,STATE QUESTION NO. 794 LEGISLATIVE REFERENDUM NO. 371,AGAINST THE PROPOSAL - NO,490031,4,4,102,110
MAYES,STATE QUESTION NO. 794 LEGISLATIVE REFERENDUM NO. 371,FOR THE PROPOSAL - YES,490034,9,9,238,256
MAYES,STATE QUESTION NO. 794 LEGISLATIVE REFERENDUM NO. 371,AGAINST THE PROPOSAL - NO,490034,4,2,56,62
MAYES,STATE QUESTION NO. 794 LEGISLATIVE REFERENDUM NO. 371,FOR THE PROPOSAL - YES,490036,25,37,767,829
MAYES,STATE QUESTION NO. 794 LEGISLATIVE REFERENDUM NO. 371,AGAINST THE PROPOSAL - NO,490036,4,8,182,194
MAYES,STATE QUESTION NO. 794 LEGISLATIVE REFERENDUM NO. 371,FOR THE PROPOSAL - YES,490037,8,19,433,460
MAYES,STATE QUESTION NO. 794 LEGISLATIVE REFERENDUM NO. 371,AGAINST THE PROPOSAL - NO,490037,6,5,115,126
MAYES,STATE QUESTION NO. 794 LEGISLATIVE REFERENDUM NO. 371,FOR THE PROPOSAL - YES,490038,5,11,172,188
MAYES,STATE QUESTION NO. 794 LEGISLATIVE REFERENDUM NO. 371,AGAINST THE PROPOSAL - NO,490038,0,4,39,43
MAYES,STATE QUESTION NO. 794 LEGISLATIVE REFERENDUM NO. 371,FOR THE PROPOSAL - YES,490039,7,33,454,494
MAYES,STATE QUESTION NO. 794 LEGISLATIVE REFERENDUM NO. 371,AGAINST THE PROPOSAL - NO,490039,6,9,117,132
MAYES,STATE QUESTION NO. 794 LEGISLATIVE REFERENDUM NO. 371,FOR THE PROPOSAL - YES,490101,8,31,238,277
MAYES,STATE QUESTION NO. 794 LEGISLATIVE REFERENDUM NO. 371,AGAINST THE PROPOSAL - NO,490101,2,10,61,73
MAYES,STATE QUESTION NO. 794 LEGISLATIVE REFERENDUM NO. 371,FOR THE PROPOSAL - YES,490121,15,58,486,559
MAYES,STATE QUESTION NO. 794 LEGISLATIVE REFERENDUM NO. 371,AGAINST THE PROPOSAL - NO,490121,5,24,124,153
MAYES,STATE QUESTION NO. 794 LEGISLATIVE REFERENDUM NO. 371,FOR THE PROPOSAL - YES,490122,2,7,69,78
MAYES,STATE QUESTION NO. 794 LEGISLATIVE REFERENDUM NO. 371,AGAINST THE PROPOSAL - NO,490122,0,0,10,10
MAYES,STATE QUESTION NO. 794 LEGISLATIVE REFERENDUM NO. 371,FOR THE PROPOSAL - YES,490130,14,33,317,364
MAYES,STATE QUESTION NO. 794 LEGISLATIVE REFERENDUM NO. 371,AGAINST THE PROPOSAL - NO,490130,2,4,88,94
MAYES,STATE QUESTION NO. 794 LEGISLATIVE REFERENDUM NO. 371,FOR THE PROPOSAL - YES,490132,15,55,365,435
MAYES,STATE QUESTION NO. 794 LEGISLATIVE REFERENDUM NO. 371,AGAINST THE PROPOSAL - NO,490132,3,8,80,91
MAYES,STATE QUESTION NO. 794 LEGISLATIVE REFERENDUM NO. 371,FOR THE PROPOSAL - YES,490241,27,137,690,854
MAYES,STATE QUESTION NO. 794 LEGISLATIVE REFERENDUM NO. 371,AGAINST THE PROPOSAL - NO,490241,5,32,171,208
MAYES,STATE QUESTION NO. 794 LEGISLATIVE REFERENDUM NO. 371,FOR THE PROPOSAL - YES,490242,9,55,414,478
MAYES,STATE QUESTION NO. 794 LEGISLATIVE REFERENDUM NO. 371,AGAINST THE PROPOSAL - NO,490242,4,11,117,132
MAYES,STATE QUESTION NO. 794 LEGISLATIVE REFERENDUM NO. 371,FOR THE PROPOSAL - YES,490311,6,7,226,239
MAYES,STATE QUESTION NO. 794 LEGISLATIVE REFERENDUM NO. 371,AGAINST THE PROPOSAL - NO,490311,0,2,66,68
MURRAY,STATE QUESTION NO. 794 LEGISLATIVE REFERENDUM NO. 371,FOR THE PROPOSAL - YES,500004,23,65,433,521
MURRAY,STATE QUESTION NO. 794 LEGISLATIVE REFERENDUM NO. 371,AGAINST THE PROPOSAL - NO,500004,5,18,102,125
MURRAY,STATE QUESTION NO. 794 LEGISLATIVE REFERENDUM NO. 371,FOR THE PROPOSAL - YES,500005,21,53,649,723
MURRAY,STATE QUESTION NO. 794 LEGISLATIVE REFERENDUM NO. 371,AGAINST THE PROPOSAL - NO,500005,6,15,137,158
MURRAY,STATE QUESTION NO. 794 LEGISLATIVE REFERENDUM NO. 371,FOR THE PROPOSAL - YES,500007,5,17,196,218
MURRAY,STATE QUESTION NO. 794 LEGISLATIVE REFERENDUM NO. 371,AGAINST THE PROPOSAL - NO,500007,2,0,33,35
MURRAY,STATE QUESTION NO. 794 LEGISLATIVE REFERENDUM NO. 371,FOR THE PROPOSAL - YES,500009,10,30,221,261
MURRAY,STATE QUESTION NO. 794 LEGISLATIVE REFERENDUM NO. 371,AGAINST THE PROPOSAL - NO,500009,2,5,46,53
MURRAY,STATE QUESTION NO. 794 LEGISLATIVE REFERENDUM NO. 371,FOR THE PROPOSAL - YES,500012,4,8,188,200
MURRAY,STATE QUESTION NO. 794 LEGISLATIVE REFERENDUM NO. 371,AGAINST THE PROPOSAL - NO,500012,1,2,51,54
MURRAY,STATE QUESTION NO. 794 LEGISLATIVE REFERENDUM NO. 371,FOR THE PROPOSAL - YES,500014,0,12,86,98
MURRAY,STATE QUESTION NO. 794 LEGISLATIVE REFERENDUM NO. 371,AGAINST THE PROPOSAL - NO,500014,0,1,43,44
MURRAY,STATE QUESTION NO. 794 LEGISLATIVE REFERENDUM NO. 371,FOR THE PROPOSAL - YES,500015,31,104,461,596
MURRAY,STATE QUESTION NO. 794 LEGISLATIVE REFERENDUM NO. 371,AGAINST THE PROPOSAL - NO,500015,7,21,107,135
MURRAY,STATE QUESTION NO. 794 LEGISLATIVE REFERENDUM NO. 371,FOR THE PROPOSAL - YES,500017,5,2,50,57
MURRAY,STATE QUESTION NO. 794 LEGISLATIVE REFERENDUM NO. 371,AGAINST THE PROPOSAL - NO,500017,0,0,16,16
MURRAY,STATE QUESTION NO. 794 LEGISLATIVE REFERENDUM NO. 371,FOR THE PROPOSAL - YES,500018,5,21,266,292
MURRAY,STATE QUESTION NO. 794 LEGISLATIVE REFERENDUM NO. 371,AGAINST THE PROPOSAL - NO,500018,2,8,51,61
MURRAY,STATE QUESTION NO. 794 LEGISLATIVE REFERENDUM NO. 371,FOR THE PROPOSAL - YES,500020,15,80,439,534
MURRAY,STATE QUESTION NO. 794 LEGISLATIVE REFERENDUM NO. 371,AGAINST THE PROPOSAL - NO,500020,8,18,90,116
MUSKOGEE,STATE QUESTION NO. 794 LEGISLATIVE REFERENDUM NO. 371,FOR THE PROPOSAL - YES,510005,23,79,645,747
MUSKOGEE,STATE QUESTION NO. 794 LEGISLATIVE REFERENDUM NO. 371,AGAINST THE PROPOSAL - NO,510005,6,20,169,195
MUSKOGEE,STATE QUESTION NO. 794 LEGISLATIVE REFERENDUM NO. 371,FOR THE PROPOSAL - YES,510007,34,140,854,1028
MUSKOGEE,STATE QUESTION NO. 794 LEGISLATIVE REFERENDUM NO. 371,AGAINST THE PROPOSAL - NO,510007,8,23,235,266
MUSKOGEE,STATE QUESTION NO. 794 LEGISLATIVE REFERENDUM NO. 371,FOR THE PROPOSAL - YES,510009,42,172,895,1109
MUSKOGEE,STATE QUESTION NO. 794 LEGISLATIVE REFERENDUM NO. 371,AGAINST THE PROPOSAL - NO,510009,6,30,226,262
MUSKOGEE,STATE QUESTION NO. 794 LEGISLATIVE REFERENDUM NO. 371,FOR THE PROPOSAL - YES,510011,12,25,339,376
MUSKOGEE,STATE QUESTION NO. 794 LEGISLATIVE REFERENDUM NO. 371,AGAINST THE PROPOSAL - NO,510011,3,9,80,92
MUSKOGEE,STATE QUESTION NO. 794 LEGISLATIVE REFERENDUM NO. 371,FOR THE PROPOSAL - YES,510013,9,55,507,571
MUSKOGEE,STATE QUESTION NO. 794 LEGISLATIVE REFERENDUM NO. 371,AGAINST THE PROPOSAL - NO,510013,5,9,117,131
MUSKOGEE,STATE QUESTION NO. 794 LEGISLATIVE REFERENDUM NO. 371,FOR THE PROPOSAL - YES,510017,7,24,188,219
MUSKOGEE,STATE QUESTION NO. 794 LEGISLATIVE REFERENDUM NO. 371,AGAINST THE PROPOSAL - NO,510017,2,5,47,54
MUSKOGEE,STATE QUESTION NO. 794 LEGISLATIVE REFERENDUM NO. 371,FOR THE PROPOSAL - YES,510021,17,51,423,491
MUSKOGEE,STATE QUESTION NO. 794 LEGISLATIVE REFERENDUM NO. 371,AGAINST THE PROPOSAL - NO,510021,3,14,106,123
MUSKOGEE,STATE QUESTION NO. 794 LEGISLATIVE REFERENDUM NO. 371,FOR THE PROPOSAL - YES,510022,31,95,593,719
MUSKOGEE,STATE QUESTION NO. 794 LEGISLATIVE REFERENDUM NO. 371,AGAINST THE PROPOSAL - NO,510022,10,25,126,161
MUSKOGEE,STATE QUESTION NO. 794 LEGISLATIVE REFERENDUM NO. 371,FOR THE PROPOSAL - YES,510023,14,72,453,539
MUSKOGEE,STATE QUESTION NO. 794 LEGISLATIVE REFERENDUM NO. 371,AGAINST THE PROPOSAL - NO,510023,6,23,121,150
MUSKOGEE,STATE QUESTION NO. 794 LEGISLATIVE REFERENDUM NO. 371,FOR THE PROPOSAL - YES,510028,3,35,283,321
MUSKOGEE,STATE QUESTION NO. 794 LEGISLATIVE REFERENDUM NO. 371,AGAINST THE PROPOSAL - NO,510028,2,4,63,69
MUSKOGEE,STATE QUESTION NO. 794 LEGISLATIVE REFERENDUM NO. 371,FOR THE PROPOSAL - YES,510033,33,26,648,707
MUSKOGEE,STATE QUESTION NO. 794 LEGISLATIVE REFERENDUM NO. 371,AGAINST THE PROPOSAL - NO,510033,9,3,196,208
MUSKOGEE,STATE QUESTION NO. 794 LEGISLATIVE REFERENDUM NO. 371,FOR THE PROPOSAL - YES,510036,0,6,98,104
MUSKOGEE,STATE QUESTION NO. 794 LEGISLATIVE REFERENDUM NO. 371,AGAINST THE PROPOSAL - NO,510036,1,1,43,45
MUSKOGEE,STATE QUESTION NO. 794 LEGISLATIVE REFERENDUM NO. 371,FOR THE PROPOSAL - YES,510037,8,31,432,471
MUSKOGEE,STATE QUESTION NO. 794 LEGISLATIVE REFERENDUM NO. 371,AGAINST THE PROPOSAL - NO,510037,2,10,112,124
MUSKOGEE,STATE QUESTION NO. 794 LEGISLATIVE REFERENDUM NO. 371,FOR THE PROPOSAL - YES,510038,34,116,596,746
MUSKOGEE,STATE QUESTION NO. 794 LEGISLATIVE REFERENDUM NO. 371,AGAINST THE PROPOSAL - NO,510038,8,39,149,196
MUSKOGEE,STATE QUESTION NO. 794 LEGISLATIVE REFERENDUM NO. 371,FOR THE PROPOSAL - YES,510040,6,28,196,230
MUSKOGEE,STATE QUESTION NO. 794 LEGISLATIVE REFERENDUM NO. 371,AGAINST THE PROPOSAL - NO,510040,6,1,49,56
MUSKOGEE,STATE QUESTION NO. 794 LEGISLATIVE REFERENDUM NO. 371,FOR THE PROPOSAL - YES,510041,54,151,1148,1353
MUSKOGEE,STATE QUESTION NO. 794 LEGISLATIVE REFERENDUM NO. 371,AGAINST THE PROPOSAL - NO,510041,10,24,277,311
MUSKOGEE,STATE QUESTION NO. 794 LEGISLATIVE REFERENDUM NO. 371,FOR THE PROPOSAL - YES,510044,6,5,307,318
MUSKOGEE,STATE QUESTION NO. 794 LEGISLATIVE REFERENDUM NO. 371,AGAINST THE PROPOSAL - NO,510044,2,3,66,71
MUSKOGEE,STATE QUESTION NO. 794 LEGISLATIVE REFERENDUM NO. 371,FOR THE PROPOSAL - YES,510045,8,18,366,392
MUSKOGEE,STATE QUESTION NO. 794 LEGISLATIVE REFERENDUM NO. 371,AGAINST THE PROPOSAL - NO,510045,0,3,81,84
MUSKOGEE,STATE QUESTION NO. 794 LEGISLATIVE REFERENDUM NO. 371,FOR THE PROPOSAL - YES,510046,14,54,576,644
MUSKOGEE,STATE QUESTION NO. 794 LEGISLATIVE REFERENDUM NO. 371,AGAINST THE PROPOSAL - NO,510046,4,15,166,185
MUSKOGEE,STATE QUESTION NO. 794 LEGISLATIVE REFERENDUM NO. 371,FOR THE PROPOSAL - YES,510047,10,44,386,440
MUSKOGEE,STATE QUESTION NO. 794 LEGISLATIVE REFERENDUM NO. 371,AGAINST THE PROPOSAL - NO,510047,5,6,107,118
MUSKOGEE,STATE QUESTION NO. 794 LEGISLATIVE REFERENDUM NO. 371,FOR THE PROPOSAL - YES,510049,5,21,137,163
MUSKOGEE,STATE QUESTION NO. 794 LEGISLATIVE REFERENDUM NO. 371,AGAINST THE PROPOSAL - NO,510049,2,11,39,52
MUSKOGEE,STATE QUESTION NO. 794 LEGISLATIVE REFERENDUM NO. 371,FOR THE PROPOSAL - YES,510050,2,7,138,147
MUSKOGEE,STATE QUESTION NO. 794 LEGISLATIVE REFERENDUM NO. 371,AGAINST THE PROPOSAL - NO,510050,0,0,36,36
MUSKOGEE,STATE QUESTION NO. 794 LEGISLATIVE REFERENDUM NO. 371,FOR THE PROPOSAL - YES,510051,0,1,84,85
MUSKOGEE,STATE QUESTION NO. 794 LEGISLATIVE REFERENDUM NO. 371,AGAINST THE PROPOSAL - NO,510051,1,0,16,17
MUSKOGEE,STATE QUESTION NO. 794 LEGISLATIVE REFERENDUM NO. 371,FOR THE PROPOSAL - YES,510052,3,11,148,162
MUSKOGEE,STATE QUESTION NO. 794 LEGISLATIVE REFERENDUM NO. 371,AGAINST THE PROPOSAL - NO,510052,0,5,46,51
MUSKOGEE,STATE QUESTION NO. 794 LEGISLATIVE REFERENDUM NO. 371,FOR THE PROPOSAL - YES,510053,10,11,336,357
MUSKOGEE,STATE QUESTION NO. 794 LEGISLATIVE REFERENDUM NO. 371,AGAINST THE PROPOSAL - NO,510053,5,9,95,109
MUSKOGEE,STATE QUESTION NO. 794 LEGISLATIVE REFERENDUM NO. 371,FOR THE PROPOSAL - YES,510055,36,182,1017,1235
MUSKOGEE,STATE QUESTION NO. 794 LEGISLATIVE REFERENDUM NO. 371,AGAINST THE PROPOSAL - NO,510055,23,27,272,322
MUSKOGEE,STATE QUESTION NO. 794 LEGISLATIVE REFERENDUM NO. 371,FOR THE PROPOSAL - YES,510056,3,6,96,105
MUSKOGEE,STATE QUESTION NO. 794 LEGISLATIVE REFERENDUM NO. 371,AGAINST THE PROPOSAL - NO,510056,1,2,17,20
MUSKOGEE,STATE QUESTION NO. 794 LEGISLATIVE REFERENDUM NO. 371,FOR THE PROPOSAL - YES,510057,0,0,14,14
MUSKOGEE,STATE QUESTION NO. 794 LEGISLATIVE REFERENDUM NO. 371,AGAINST THE PROPOSAL - NO,510057,0,2,9,11
MUSKOGEE,STATE QUESTION NO. 794 LEGISLATIVE REFERENDUM NO. 371,FOR THE PROPOSAL - YES,510058,6,6,268,280
MUSKOGEE,STATE QUESTION NO. 794 LEGISLATIVE REFERENDUM NO. 371,AGAINST THE PROPOSAL - NO,510058,2,3,88,93
MUSKOGEE,STATE QUESTION NO. 794 LEGISLATIVE REFERENDUM NO. 371,FOR THE PROPOSAL - YES,510059,7,18,408,433
MUSKOGEE,STATE QUESTION NO. 794 LEGISLATIVE REFERENDUM NO. 371,AGAINST THE PROPOSAL - NO,510059,3,3,115,121
MUSKOGEE,STATE QUESTION NO. 794 LEGISLATIVE REFERENDUM NO. 371,FOR THE PROPOSAL - YES,510060,4,3,124,131
MUSKOGEE,STATE QUESTION NO. 794 LEGISLATIVE REFERENDUM NO. 371,AGAINST THE PROPOSAL - NO,510060,1,0,24,25
MUSKOGEE,STATE QUESTION NO. 794 LEGISLATIVE REFERENDUM NO. 371,FOR THE PROPOSAL - YES,510061,6,10,214,230
MUSKOGEE,STATE QUESTION NO. 794 LEGISLATIVE REFERENDUM NO. 371,AGAINST THE PROPOSAL - NO,510061,0,10,74,84
MUSKOGEE,STATE QUESTION NO. 794 LEGISLATIVE REFERENDUM NO. 371,FOR THE PROPOSAL - YES,510064,7,22,426,455
MUSKOGEE,STATE QUESTION NO. 794 LEGISLATIVE REFERENDUM NO. 371,AGAINST THE PROPOSAL - NO,510064,3,3,132,138
NOBLE,STATE QUESTION NO. 794 LEGISLATIVE REFERENDUM NO. 371,FOR THE PROPOSAL - YES,520101,20,91,351,462
NOBLE,STATE QUESTION NO. 794 LEGISLATIVE REFERENDUM NO. 371,AGAINST THE PROPOSAL - NO,520101,2,19,85,106
NOBLE,STATE QUESTION NO. 794 LEGISLATIVE REFERENDUM NO. 371,FOR THE PROPOSAL - YES,520102,5,18,103,126
NOBLE,STATE QUESTION NO. 794 LEGISLATIVE REFERENDUM NO. 371,AGAINST THE PROPOSAL - NO,520102,0,3,30,33
NOBLE,STATE QUESTION NO. 794 LEGISLATIVE REFERENDUM NO. 371,FOR THE PROPOSAL - YES,520103,17,2,124,143
NOBLE,STATE QUESTION NO. 794 LEGISLATIVE REFERENDUM NO. 371,AGAINST THE PROPOSAL - NO,520103,2,1,32,35
NOBLE,STATE QUESTION NO. 794 LEGISLATIVE REFERENDUM NO. 371,FOR THE PROPOSAL - YES,520104,2,5,132,139
NOBLE,STATE QUESTION NO. 794 LEGISLATIVE REFERENDUM NO. 371,AGAINST THE PROPOSAL - NO,520104,0,0,38,38
NOBLE,STATE QUESTION NO. 794 LEGISLATIVE REFERENDUM NO. 371,FOR THE PROPOSAL - YES,520105,1,7,123,131
NOBLE,STATE QUESTION NO. 794 LEGISLATIVE REFERENDUM NO. 371,AGAINST THE PROPOSAL - NO,520105,0,2,25,27
NOBLE,STATE QUESTION NO. 794 LEGISLATIVE REFERENDUM NO. 371,FOR THE PROPOSAL - YES,520106,0,5,58,63
NOBLE,STATE QUESTION NO. 794 LEGISLATIVE REFERENDUM NO. 371,AGAINST THE PROPOSAL - NO,520106,1,1,22,24
NOBLE,STATE QUESTION NO. 794 LEGISLATIVE REFERENDUM NO. 371,FOR THE PROPOSAL - YES,520201,6,100,311,417
NOBLE,STATE QUESTION NO. 794 LEGISLATIVE REFERENDUM NO. 371,AGAINST THE PROPOSAL - NO,520201,2,19,72,93
NOBLE,STATE QUESTION NO. 794 LEGISLATIVE REFERENDUM NO. 371,FOR THE PROPOSAL - YES,520202,10,37,173,220
NOBLE,STATE QUESTION NO. 794 LEGISLATIVE REFERENDUM NO. 371,AGAINST THE PROPOSAL - NO,520202,7,5,51,63
NOBLE,STATE QUESTION NO. 794 LEGISLATIVE REFERENDUM NO. 371,FOR THE PROPOSAL - YES,520203,6,25,170,201
NOBLE,STATE QUESTION NO. 794 LEGISLATIVE REFERENDUM NO. 371,AGAINST THE PROPOSAL - NO,520203,0,10,31,41
NOBLE,STATE QUESTION NO. 794 LEGISLATIVE REFERENDUM NO. 371,FOR THE PROPOSAL - YES,520301,9,69,225,303
NOBLE,STATE QUESTION NO. 794 LEGISLATIVE REFERENDUM NO. 371,AGAINST THE PROPOSAL - NO,520301,1,10,63,74
NOBLE,STATE QUESTION NO. 794 LEGISLATIVE REFERENDUM NO. 371,FOR THE PROPOSAL - YES,520305,23,31,463,517
NOBLE,STATE QUESTION NO. 794 LEGISLATIVE REFERENDUM NO. 371,AGAINST THE PROPOSAL - NO,520305,3,3,124,130
NOBLE,STATE QUESTION NO. 794 LEGISLATIVE REFERENDUM NO. 371,FOR THE PROPOSAL - YES,520307,19,127,299,445
NOBLE,STATE QUESTION NO. 794 LEGISLATIVE REFERENDUM NO. 371,AGAINST THE PROPOSAL - NO,520307,5,28,73,106
NOWATA,STATE QUESTION NO. 794 LEGISLATIVE REFERENDUM NO. 371,FOR THE PROPOSAL - YES,530101,15,70,287,372
NOWATA,STATE QUESTION NO. 794 LEGISLATIVE REFERENDUM NO. 371,AGAINST THE PROPOSAL - NO,530101,1,8,72,81
NOWATA,STATE QUESTION NO. 794 LEGISLATIVE REFERENDUM NO. 371,FOR THE PROPOSAL - YES,530102,23,59,363,445
NOWATA,STATE QUESTION NO. 794 LEGISLATIVE REFERENDUM NO. 371,AGAINST THE PROPOSAL - NO,530102,3,11,85,99
NOWATA,STATE QUESTION NO. 794 LEGISLATIVE REFERENDUM NO. 371,FOR THE PROPOSAL - YES,530103,1,24,146,171
NOWATA,STATE QUESTION NO. 794 LEGISLATIVE REFERENDUM NO. 371,AGAINST THE PROPOSAL - NO,530103,0,6,35,41
NOWATA,STATE QUESTION NO. 794 LEGISLATIVE REFERENDUM NO. 371,FOR THE PROPOSAL - YES,530201,8,4,177,189
NOWATA,STATE QUESTION NO. 794 LEGISLATIVE REFERENDUM NO. 371,AGAINST THE PROPOSAL - NO,530201,3,1,48,52
NOWATA,STATE QUESTION NO. 794 LEGISLATIVE REFERENDUM NO. 371,FOR THE PROPOSAL - YES,530202,11,53,154,218
NOWATA,STATE QUESTION NO. 794 LEGISLATIVE REFERENDUM NO. 371,AGAINST THE PROPOSAL - NO,530202,1,11,47,59
NOWATA,STATE QUESTION NO. 794 LEGISLATIVE REFERENDUM NO. 371,FOR THE PROPOSAL - YES,530203,13,53,309,375
NOWATA,STATE QUESTION NO. 794 LEGISLATIVE REFERENDUM NO. 371,AGAINST THE PROPOSAL - NO,530203,0,8,76,84
NOWATA,STATE QUESTION NO. 794 LEGISLATIVE REFERENDUM NO. 371,FOR THE PROPOSAL - YES,530204,4,7,136,147
NOWATA,STATE QUESTION NO. 794 LEGISLATIVE REFERENDUM NO. 371,AGAINST THE PROPOSAL - NO,530204,0,3,43,46
NOWATA,STATE QUESTION NO. 794 LEGISLATIVE REFERENDUM NO. 371,FOR THE PROPOSAL - YES,530301,14,12,379,405
NOWATA,STATE QUESTION NO. 794 LEGISLATIVE REFERENDUM NO. 371,AGAINST THE PROPOSAL - NO,530301,3,0,94,97
NOWATA,STATE QUESTION NO. 794 LEGISLATIVE REFERENDUM NO. 371,FOR THE PROPOSAL - YES,530302,3,50,145,198
NOWATA,STATE QUESTION NO. 794 LEGISLATIVE REFERENDUM NO. 371,AGAINST THE PROPOSAL - NO,530302,1,15,46,62
NOWATA,STATE QUESTION NO. 794 LEGISLATIVE REFERENDUM NO. 371,FOR THE PROPOSAL - YES,530303,3,13,171,187
NOWATA,STATE QUESTION NO. 794 LEGISLATIVE REFERENDUM NO. 371,AGAINST THE PROPOSAL - NO,530303,0,0,24,24
NOWATA,STATE QUESTION NO. 794 LEGISLATIVE REFERENDUM NO. 371,FOR THE PROPOSAL - YES,530304,4,14,71,89
NOWATA,STATE QUESTION NO. 794 LEGISLATIVE REFERENDUM NO. 371,AGAINST THE PROPOSAL - NO,530304,1,4,19,24
OKFUSKEE,STATE QUESTION NO. 794 LEGISLATIVE REFERENDUM NO. 371,FOR THE PROPOSAL - YES,540101,13,17,374,404
OKFUSKEE,STATE QUESTION NO. 794 LEGISLATIVE REFERENDUM NO. 371,AGAINST THE PROPOSAL - NO,540101,4,9,155,168
OKFUSKEE,STATE QUESTION NO. 794 LEGISLATIVE REFERENDUM NO. 371,FOR THE PROPOSAL - YES,540102,6,9,86,101
OKFUSKEE,STATE QUESTION NO. 794 LEGISLATIVE REFERENDUM NO. 371,AGAINST THE PROPOSAL - NO,540102,2,7,21,30
OKFUSKEE,STATE QUESTION NO. 794 LEGISLATIVE REFERENDUM NO. 371,FOR THE PROPOSAL - YES,540103,2,1,76,79
OKFUSKEE,STATE QUESTION NO. 794 LEGISLATIVE REFERENDUM NO. 371,AGAINST THE PROPOSAL - NO,540103,0,1,34,35
OKFUSKEE,STATE QUESTION NO. 794 LEGISLATIVE REFERENDUM NO. 371,FOR THE PROPOSAL - YES,540105,0,16,83,99
OKFUSKEE,STATE QUESTION NO. 794 LEGISLATIVE REFERENDUM NO. 371,AGAINST THE PROPOSAL - NO,540105,0,8,28,36
OKFUSKEE,STATE QUESTION NO. 794 LEGISLATIVE REFERENDUM NO. 371,FOR THE PROPOSAL - YES,540206,14,19,155,188
OKFUSKEE,STATE QUESTION NO. 794 LEGISLATIVE REFERENDUM NO. 371,AGAINST THE PROPOSAL - NO,540206,4,5,57,66
OKFUSKEE,STATE QUESTION NO. 794 LEGISLATIVE REFERENDUM NO. 371,FOR THE PROPOSAL - YES,540207,3,5,77,85
OKFUSKEE,STATE QUESTION NO. 794 LEGISLATIVE REFERENDUM NO. 371,AGAINST THE PROPOSAL - NO,540207,0,2,15,17
OKFUSKEE,STATE QUESTION NO. 794 LEGISLATIVE REFERENDUM NO. 371,FOR THE PROPOSAL - YES,540208,7,44,168,219
OKFUSKEE,STATE QUESTION NO. 794 LEGISLATIVE REFERENDUM NO. 371,AGAINST THE PROPOSAL - NO,540208,2,17,41,60
OKFUSKEE,STATE QUESTION NO. 794 LEGISLATIVE REFERENDUM NO. 371,FOR THE PROPOSAL - YES,540209,14,46,264,324
OKFUSKEE,STATE QUESTION NO. 794 LEGISLATIVE REFERENDUM NO. 371,AGAINST THE PROPOSAL - NO,540209,6,20,121,147
OKFUSKEE,STATE QUESTION NO. 794 LEGISLATIVE REFERENDUM NO. 371,FOR THE PROPOSAL - YES,540210,4,19,93,116
OKFUSKEE,STATE QUESTION NO. 794 LEGISLATIVE REFERENDUM NO. 371,AGAINST THE PROPOSAL - NO,540210,1,6,30,37
OKFUSKEE,STATE QUESTION NO. 794 LEGISLATIVE REFERENDUM NO. 371,FOR THE PROPOSAL - YES,540311,6,22,154,182
OKFUSKEE,STATE QUESTION NO. 794 LEGISLATIVE REFERENDUM NO. 371,AGAINST THE PROPOSAL - NO,540311,3,2,47,52
OKFUSKEE,STATE QUESTION NO. 794 LEGISLATIVE REFERENDUM NO. 371,FOR THE PROPOSAL - YES,540312,9,13,207,229
OKFUSKEE,STATE QUESTION NO. 794 LEGISLATIVE REFERENDUM NO. 371,AGAINST THE PROPOSAL - NO,540312,1,7,54,62
OKFUSKEE,STATE QUESTION NO. 794 LEGISLATIVE REFERENDUM NO. 371,FOR THE PROPOSAL - YES,540313,3,3,57,63
OKFUSKEE,STATE QUESTION NO. 794 LEGISLATIVE REFERENDUM NO. 371,AGAINST THE PROPOSAL - NO,540313,0,2,10,12
OKFUSKEE,STATE QUESTION NO. 794 LEGISLATIVE REFERENDUM NO. 371,FOR THE PROPOSAL - YES,540314,8,25,118,151
OKFUSKEE,STATE QUESTION NO. 794 LEGISLATIVE REFERENDUM NO. 371,AGAINST THE PROPOSAL - NO,540314,2,8,34,44
OKLAHOMA,STATE QUESTION NO. 794 LEGISLATIVE REFERENDUM NO. 371,FOR THE PROPOSAL - YES,550001,0,0,478,478
OKLAHOMA,STATE QUESTION NO. 794 LEGISLATIVE REFERENDUM NO. 371,AGAINST THE PROPOSAL - NO,550001,0,0,92,92
OKLAHOMA,STATE QUESTION NO. 794 LEGISLATIVE REFERENDUM NO. 371,FOR THE PROPOSAL - YES,550002,0,0,446,446
OKLAHOMA,STATE QUESTION NO. 794 LEGISLATIVE REFERENDUM NO. 371,AGAINST THE PROPOSAL - NO,550002,0,0,134,134
OKLAHOMA,STATE QUESTION NO. 794 LEGISLATIVE REFERENDUM NO. 371,FOR THE PROPOSAL - YES,550003,0,0,592,592
OKLAHOMA,STATE QUESTION NO. 794 LEGISLATIVE REFERENDUM NO. 371,AGAINST THE PROPOSAL - NO,550003,0,0,176,176
OKLAHOMA,STATE QUESTION NO. 794 LEGISLATIVE REFERENDUM NO. 371,FOR THE PROPOSAL - YES,550004,0,0,683,683
OKLAHOMA,STATE QUESTION NO. 794 LEGISLATIVE REFERENDUM NO. 371,AGAINST THE PROPOSAL - NO,550004,0,0,170,170
OKLAHOMA,STATE QUESTION NO. 794 LEGISLATIVE REFERENDUM NO. 371,FOR THE PROPOSAL - YES,550005,0,0,560,560
OKLAHOMA,STATE QUESTION NO. 794 LEGISLATIVE REFERENDUM NO. 371,AGAINST THE PROPOSAL - NO,550005,0,0,148,148
OKLAHOMA,STATE QUESTION NO. 794 LEGISLATIVE REFERENDUM NO. 371,FOR THE PROPOSAL - YES,550006,0,0,414,414
OKLAHOMA,STATE QUESTION NO. 794 LEGISLATIVE REFERENDUM NO. 371,AGAINST THE PROPOSAL - NO,550006,0,0,128,128
OKLAHOMA,STATE QUESTION NO. 794 LEGISLATIVE REFERENDUM NO. 371,FOR THE PROPOSAL - YES,550007,0,0,733,733
OKLAHOMA,STATE QUESTION NO. 794 LEGISLATIVE REFERENDUM NO. 371,AGAINST THE PROPOSAL - NO,550007,0,0,162,162
OKLAHOMA,STATE QUESTION NO. 794 LEGISLATIVE REFERENDUM NO. 371,FOR THE PROPOSAL - YES,550008,0,0,302,302
OKLAHOMA,STATE QUESTION NO. 794 LEGISLATIVE REFERENDUM NO. 371,AGAINST THE PROPOSAL - NO,550008,0,0,92,92
OKLAHOMA,STATE QUESTION NO. 794 LEGISLATIVE REFERENDUM NO. 371,FOR THE PROPOSAL - YES,550009,0,0,389,389
OKLAHOMA,STATE QUESTION NO. 794 LEGISLATIVE REFERENDUM NO. 371,AGAINST THE PROPOSAL - NO,550009,0,0,116,116
OKLAHOMA,STATE QUESTION NO. 794 LEGISLATIVE REFERENDUM NO. 371,FOR THE PROPOSAL - YES,550010,0,0,319,319
OKLAHOMA,STATE QUESTION NO. 794 LEGISLATIVE REFERENDUM NO. 371,AGAINST THE PROPOSAL - NO,550010,0,0,89,89
OKLAHOMA,STATE QUESTION NO. 794 LEGISLATIVE REFERENDUM NO. 371,FOR THE PROPOSAL - YES,550011,0,0,482,482
OKLAHOMA,STATE QUESTION NO. 794 LEGISLATIVE REFERENDUM NO. 371,AGAINST THE PROPOSAL - NO,550011,0,0,98,98
OKLAHOMA,STATE QUESTION NO. 794 LEGISLATIVE REFERENDUM NO. 371,FOR THE PROPOSAL - YES,550012,0,0,769,769
OKLAHOMA,STATE QUESTION NO. 794 LEGISLATIVE REFERENDUM NO. 371,AGAINST THE PROPOSAL - NO,550012,0,0,211,211
OKLAHOMA,STATE QUESTION NO. 794 LEGISLATIVE REFERENDUM NO. 371,FOR THE PROPOSAL - YES,550013,0,0,512,512
OKLAHOMA,STATE QUESTION NO. 794 LEGISLATIVE REFERENDUM NO. 371,AGAINST THE PROPOSAL - NO,550013,0,0,145,145
OKLAHOMA,STATE QUESTION NO. 794 LEGISLATIVE REFERENDUM NO. 371,FOR THE PROPOSAL - YES,550014,0,0,508,508
OKLAHOMA,STATE QUESTION NO. 794 LEGISLATIVE REFERENDUM NO. 371,AGAINST THE PROPOSAL - NO,550014,0,0,145,145
OKLAHOMA,STATE QUESTION NO. 794 LEGISLATIVE REFERENDUM NO. 371,FOR THE PROPOSAL - YES,550015,0,0,643,643
OKLAHOMA,STATE QUESTION NO. 794 LEGISLATIVE REFERENDUM NO. 371,AGAINST THE PROPOSAL - NO,550015,0,0,197,197
OKLAHOMA,STATE QUESTION NO. 794 LEGISLATIVE REFERENDUM NO. 371,FOR THE PROPOSAL - YES,550016,0,0,149,149
OKLAHOMA,STATE QUESTION NO. 794 LEGISLATIVE REFERENDUM NO. 371,AGAINST THE PROPOSAL - NO,550016,0,0,43,43
OKLAHOMA,STATE QUESTION NO. 794 LEGISLATIVE REFERENDUM NO. 371,FOR THE PROPOSAL - YES,550017,0,0,0,0
OKLAHOMA,STATE QUESTION NO. 794 LEGISLATIVE REFERENDUM NO. 371,AGAINST THE PROPOSAL - NO,550017,0,0,0,0
OKLAHOMA,STATE QUESTION NO. 794 LEGISLATIVE REFERENDUM NO. 371,FOR THE PROPOSAL - YES,550018,0,0,231,231
OKLAHOMA,STATE QUESTION NO. 794 LEGISLATIVE REFERENDUM NO. 371,AGAINST THE PROPOSAL - NO,550018,0,0,63,63
OKLAHOMA,STATE QUESTION NO. 794 LEGISLATIVE REFERENDUM NO. 371,FOR THE PROPOSAL - YES,550019,0,0,596,596
OKLAHOMA,STATE QUESTION NO. 794 LEGISLATIVE REFERENDUM NO. 371,AGAINST THE PROPOSAL - NO,550019,0,0,140,140
OKLAHOMA,STATE QUESTION NO. 794 LEGISLATIVE REFERENDUM NO. 371,FOR THE PROPOSAL - YES,550020,0,0,913,913
OKLAHOMA,STATE QUESTION NO. 794 LEGISLATIVE REFERENDUM NO. 371,AGAINST THE PROPOSAL - NO,550020,0,0,222,222
OKLAHOMA,STATE QUESTION NO. 794 LEGISLATIVE REFERENDUM NO. 371,FOR THE PROPOSAL - YES,550021,0,0,986,986
OKLAHOMA,STATE QUESTION NO. 794 LEGISLATIVE REFERENDUM NO. 371,AGAINST THE PROPOSAL - NO,550021,0,0,192,192
OKLAHOMA,STATE QUESTION NO. 794 LEGISLATIVE REFERENDUM NO. 371,FOR THE PROPOSAL - YES,550022,0,0,542,542
OKLAHOMA,STATE QUESTION NO. 794 LEGISLATIVE REFERENDUM NO. 371,AGAINST THE PROPOSAL - NO,550022,0,0,117,117
OKLAHOMA,STATE QUESTION NO. 794 LEGISLATIVE REFERENDUM NO. 371,FOR THE PROPOSAL - YES,550023,0,0,811,811
OKLAHOMA,STATE QUESTION NO. 794 LEGISLATIVE REFERENDUM NO. 371,AGAINST THE PROPOSAL - NO,550023,0,0,193,193
OKLAHOMA,STATE QUESTION NO. 794 LEGISLATIVE REFERENDUM NO. 371,FOR THE PROPOSAL - YES,550024,0,0,52,52
OKLAHOMA,STATE QUESTION NO. 794 LEGISLATIVE REFERENDUM NO. 371,AGAINST THE PROPOSAL - NO,550024,0,0,14,14
OKLAHOMA,STATE QUESTION NO. 794 LEGISLATIVE REFERENDUM NO. 371,FOR THE PROPOSAL - YES,550025,0,0,207,207
OKLAHOMA,STATE QUESTION NO. 794 LEGISLATIVE REFERENDUM NO. 371,AGAINST THE PROPOSAL - NO,550025,0,0,53,53
OKLAHOMA,STATE QUESTION NO. 794 LEGISLATIVE REFERENDUM NO. 371,FOR THE PROPOSAL - YES,550026,0,0,431,431
OKLAHOMA,STATE QUESTION NO. 794 LEGISLATIVE REFERENDUM NO. 371,AGAINST THE PROPOSAL - NO,550026,0,0,92,92
OKLAHOMA,STATE QUESTION NO. 794 LEGISLATIVE REFERENDUM NO. 371,FOR THE PROPOSAL - YES,550027,0,0,85,85
OKLAHOMA,STATE QUESTION NO. 794 LEGISLATIVE REFERENDUM NO. 371,AGAINST THE PROPOSAL - NO,550027,0,0,26,26
OKLAHOMA,STATE QUESTION NO. 794 LEGISLATIVE REFERENDUM NO. 371,FOR THE PROPOSAL - YES,550028,0,0,567,567
OKLAHOMA,STATE QUESTION NO. 794 LEGISLATIVE REFERENDUM NO. 371,AGAINST THE PROPOSAL - NO,550028,0,0,136,136
OKLAHOMA,STATE QUESTION NO. 794 LEGISLATIVE REFERENDUM NO. 371,FOR THE PROPOSAL - YES,550029,0,0,760,760
OKLAHOMA,STATE QUESTION NO. 794 LEGISLATIVE REFERENDUM NO. 371,AGAINST THE PROPOSAL - NO,550029,0,0,165,165
OKLAHOMA,STATE QUESTION NO. 794 LEGISLATIVE REFERENDUM NO. 371,FOR THE PROPOSAL - YES,550030,0,0,620,620
OKLAHOMA,STATE QUESTION NO. 794 LEGISLATIVE REFERENDUM NO. 371,AGAINST THE PROPOSAL - NO,550030,0,0,139,139
OKLAHOMA,STATE QUESTION NO. 794 LEGISLATIVE REFERENDUM NO. 371,FOR THE PROPOSAL - YES,550031,0,0,723,723
OKLAHOMA,STATE QUESTION NO. 794 LEGISLATIVE REFERENDUM NO. 371,AGAINST THE PROPOSAL - NO,550031,0,0,156,156
OKLAHOMA,STATE QUESTION NO. 794 LEGISLATIVE REFERENDUM NO. 371,FOR THE PROPOSAL - YES,550032,0,0,477,477
OKLAHOMA,STATE QUESTION NO. 794 LEGISLATIVE REFERENDUM NO. 371,AGAINST THE PROPOSAL - NO,550032,0,0,118,118
OKLAHOMA,STATE QUESTION NO. 794 LEGISLATIVE REFERENDUM NO. 371,FOR THE PROPOSAL - YES,550033,0,0,975,975
OKLAHOMA,STATE QUESTION NO. 794 LEGISLATIVE REFERENDUM NO. 371,AGAINST THE PROPOSAL - NO,550033,0,0,237,237
OKLAHOMA,STATE QUESTION NO. 794 LEGISLATIVE REFERENDUM NO. 371,FOR THE PROPOSAL - YES,550034,0,0,611,611
OKLAHOMA,STATE QUESTION NO. 794 LEGISLATIVE REFERENDUM NO. 371,AGAINST THE PROPOSAL - NO,550034,0,0,171,171
OKLAHOMA,STATE QUESTION NO. 794 LEGISLATIVE REFERENDUM NO. 371,FOR THE PROPOSAL - YES,550035,0,0,1319,1319
OKLAHOMA,STATE QUESTION NO. 794 LEGISLATIVE REFERENDUM NO. 371,AGAINST THE PROPOSAL - NO,550035,0,0,358,358
OKLAHOMA,STATE QUESTION NO. 794 LEGISLATIVE REFERENDUM NO. 371,FOR THE PROPOSAL - YES,550036,0,0,811,811
OKLAHOMA,STATE QUESTION NO. 794 LEGISLATIVE REFERENDUM NO. 371,AGAINST THE PROPOSAL - NO,550036,0,0,212,212
OKLAHOMA,STATE QUESTION NO. 794 LEGISLATIVE REFERENDUM NO. 371,FOR THE PROPOSAL - YES,550037,0,0,703,703
OKLAHOMA,STATE QUESTION NO. 794 LEGISLATIVE REFERENDUM NO. 371,AGAINST THE PROPOSAL - NO,550037,0,0,181,181
OKLAHOMA,STATE QUESTION NO. 794 LEGISLATIVE REFERENDUM NO. 371,FOR THE PROPOSAL - YES,550038,0,0,636,636
OKLAHOMA,STATE QUESTION NO. 794 LEGISLATIVE REFERENDUM NO. 371,AGAINST THE PROPOSAL - NO,550038,0,0,137,137
OKLAHOMA,STATE QUESTION NO. 794 LEGISLATIVE REFERENDUM NO. 371,FOR THE PROPOSAL - YES,550039,0,0,799,799
OKLAHOMA,STATE QUESTION NO. 794 LEGISLATIVE REFERENDUM NO. 371,AGAINST THE PROPOSAL - NO,550039,0,0,240,240
OKLAHOMA,STATE QUESTION NO. 794 LEGISLATIVE REFERENDUM NO. 371,FOR THE PROPOSAL - YES,550040,0,0,918,918
OKLAHOMA,STATE QUESTION NO. 794 LEGISLATIVE REFERENDUM NO. 371,AGAINST THE PROPOSAL - NO,550040,0,0,248,248
OKLAHOMA,STATE QUESTION NO. 794 LEGISLATIVE REFERENDUM NO. 371,FOR THE PROPOSAL - YES,550041,0,0,726,726
OKLAHOMA,STATE QUESTION NO. 794 LEGISLATIVE REFERENDUM NO. 371,AGAINST THE PROPOSAL - NO,550041,0,0,224,224
OKLAHOMA,STATE QUESTION NO. 794 LEGISLATIVE REFERENDUM NO. 371,FOR THE PROPOSAL - YES,550042,0,0,1028,1028
OKLAHOMA,STATE QUESTION NO. 794 LEGISLATIVE REFERENDUM NO. 371,AGAINST THE PROPOSAL - NO,550042,0,0,262,262
OKLAHOMA,STATE QUESTION NO. 794 LEGISLATIVE REFERENDUM NO. 371,FOR THE PROPOSAL - YES,550043,0,0,1458,1458
OKLAHOMA,STATE QUESTION NO. 794 LEGISLATIVE REFERENDUM NO. 371,AGAINST THE PROPOSAL - NO,550043,0,0,317,317
OKLAHOMA,STATE QUESTION NO. 794 LEGISLATIVE REFERENDUM NO. 371,FOR THE PROPOSAL - YES,550044,0,0,1156,1156
OKLAHOMA,STATE QUESTION NO. 794 LEGISLATIVE REFERENDUM NO. 371,AGAINST THE PROPOSAL - NO,550044,0,0,279,279
OKLAHOMA,STATE QUESTION NO. 794 LEGISLATIVE REFERENDUM NO. 371,FOR THE PROPOSAL - YES,550045,0,0,1134,1134
OKLAHOMA,STATE QUESTION NO. 794 LEGISLATIVE REFERENDUM NO. 371,AGAINST THE PROPOSAL - NO,550045,0,0,279,279
OKLAHOMA,STATE QUESTION NO. 794 LEGISLATIVE REFERENDUM NO. 371,FOR THE PROPOSAL - YES,550046,0,0,441,441
OKLAHOMA,STATE QUESTION NO. 794 LEGISLATIVE REFERENDUM NO. 371,AGAINST THE PROPOSAL - NO,550046,0,0,120,120
OKLAHOMA,STATE QUESTION NO. 794 LEGISLATIVE REFERENDUM NO. 371,FOR THE PROPOSAL - YES,550047,0,0,341,341
OKLAHOMA,STATE QUESTION NO. 794 LEGISLATIVE REFERENDUM NO. 371,AGAINST THE PROPOSAL - NO,550047,0,0,116,116
OKLAHOMA,STATE QUESTION NO. 794 LEGISLATIVE REFERENDUM NO. 371,FOR THE PROPOSAL - YES,550048,0,0,564,564
OKLAHOMA,STATE QUESTION NO. 794 LEGISLATIVE REFERENDUM NO. 371,AGAINST THE PROPOSAL - NO,550048,0,0,155,155
OKLAHOMA,STATE QUESTION NO. 794 LEGISLATIVE REFERENDUM NO. 371,FOR THE PROPOSAL - YES,550049,0,0,430,430
OKLAHOMA,STATE QUESTION NO. 794 LEGISLATIVE REFERENDUM NO. 371,AGAINST THE PROPOSAL - NO,550049,0,0,122,122
OKLAHOMA,STATE QUESTION NO. 794 LEGISLATIVE REFERENDUM NO. 371,FOR THE PROPOSAL - YES,550050,0,0,30,30
OKLAHOMA,STATE QUESTION NO. 794 LEGISLATIVE REFERENDUM NO. 371,AGAINST THE PROPOSAL - NO,550050,0,0,5,5
OKLAHOMA,STATE QUESTION NO. 794 LEGISLATIVE REFERENDUM NO. 371,FOR THE PROPOSAL - YES,550051,0,0,610,610
OKLAHOMA,STATE QUESTION NO. 794 LEGISLATIVE REFERENDUM NO. 371,AGAINST THE PROPOSAL - NO,550051,0,0,191,191
OKLAHOMA,STATE QUESTION NO. 794 LEGISLATIVE REFERENDUM NO. 371,FOR THE PROPOSAL - YES,550052,0,0,604,604
OKLAHOMA,STATE QUESTION NO. 794 LEGISLATIVE REFERENDUM NO. 371,AGAINST THE PROPOSAL - NO,550052,0,0,185,185
OKLAHOMA,STATE QUESTION NO. 794 LEGISLATIVE REFERENDUM NO. 371,FOR THE PROPOSAL - YES,550053,0,0,613,613
OKLAHOMA,STATE QUESTION NO. 794 LEGISLATIVE REFERENDUM NO. 371,AGAINST THE PROPOSAL - NO,550053,0,0,160,160
OKLAHOMA,STATE QUESTION NO. 794 LEGISLATIVE REFERENDUM NO. 371,FOR THE PROPOSAL - YES,550054,0,0,744,744
OKLAHOMA,STATE QUESTION NO. 794 LEGISLATIVE REFERENDUM NO. 371,AGAINST THE PROPOSAL - NO,550054,0,0,155,155
OKLAHOMA,STATE QUESTION NO. 794 LEGISLATIVE REFERENDUM NO. 371,FOR THE PROPOSAL - YES,550055,0,0,630,630
OKLAHOMA,STATE QUESTION NO. 794 LEGISLATIVE REFERENDUM NO. 371,AGAINST THE PROPOSAL - NO,550055,0,0,198,198
OKLAHOMA,STATE QUESTION NO. 794 LEGISLATIVE REFERENDUM NO. 371,FOR THE PROPOSAL - YES,550056,0,0,621,621
OKLAHOMA,STATE QUESTION NO. 794 LEGISLATIVE REFERENDUM NO. 371,AGAINST THE PROPOSAL - NO,550056,0,0,174,174
OKLAHOMA,STATE QUESTION NO. 794 LEGISLATIVE REFERENDUM NO. 371,FOR THE PROPOSAL - YES,550057,0,0,597,597
OKLAHOMA,STATE QUESTION NO. 794 LEGISLATIVE REFERENDUM NO. 371,AGAINST THE PROPOSAL - NO,550057,0,0,151,151
OKLAHOMA,STATE QUESTION NO. 794 LEGISLATIVE REFERENDUM NO. 371,FOR THE PROPOSAL - YES,550058,0,0,1307,1307
OKLAHOMA,STATE QUESTION NO. 794 LEGISLATIVE REFERENDUM NO. 371,AGAINST THE PROPOSAL - NO,550058,0,0,337,337
OKLAHOMA,STATE QUESTION NO. 794 LEGISLATIVE REFERENDUM NO. 371,FOR THE PROPOSAL - YES,550059,0,0,984,984
OKLAHOMA,STATE QUESTION NO. 794 LEGISLATIVE REFERENDUM NO. 371,AGAINST THE PROPOSAL - NO,550059,0,0,268,268
OKLAHOMA,STATE QUESTION NO. 794 LEGISLATIVE REFERENDUM NO. 371,FOR THE PROPOSAL - YES,550060,0,0,1236,1236
OKLAHOMA,STATE QUESTION NO. 794 LEGISLATIVE REFERENDUM NO. 371,AGAINST THE PROPOSAL - NO,550060,0,0,338,338
OKLAHOMA,STATE QUESTION NO. 794 LEGISLATIVE REFERENDUM NO. 371,FOR THE PROPOSAL - YES,550061,0,0,998,998
OKLAHOMA,STATE QUESTION NO. 794 LEGISLATIVE REFERENDUM NO. 371,AGAINST THE PROPOSAL - NO,550061,0,0,261,261
OKLAHOMA,STATE QUESTION NO. 794 LEGISLATIVE REFERENDUM NO. 371,FOR THE PROPOSAL - YES,550062,0,0,1187,1187
OKLAHOMA,STATE QUESTION NO. 794 LEGISLATIVE REFERENDUM NO. 371,AGAINST THE PROPOSAL - NO,550062,0,0,305,305
OKLAHOMA,STATE QUESTION NO. 794 LEGISLATIVE REFERENDUM NO. 371,FOR THE PROPOSAL - YES,550063,0,0,467,467
OKLAHOMA,STATE QUESTION NO. 794 LEGISLATIVE REFERENDUM NO. 371,AGAINST THE PROPOSAL - NO,550063,0,0,104,104
OKLAHOMA,STATE QUESTION NO. 794 LEGISLATIVE REFERENDUM NO. 371,FOR THE PROPOSAL - YES,550064,0,0,1303,1303
OKLAHOMA,STATE QUESTION NO. 794 LEGISLATIVE REFERENDUM NO. 371,AGAINST THE PROPOSAL - NO,550064,0,0,321,321
OKLAHOMA,STATE QUESTION NO. 794 LEGISLATIVE REFERENDUM NO. 371,FOR THE PROPOSAL - YES,550065,0,0,742,742
OKLAHOMA,STATE QUESTION NO. 794 LEGISLATIVE REFERENDUM NO. 371,AGAINST THE PROPOSAL - NO,550065,0,0,173,173
OKLAHOMA,STATE QUESTION NO. 794 LEGISLATIVE REFERENDUM NO. 371,FOR THE PROPOSAL - YES,550066,0,0,661,661
OKLAHOMA,STATE QUESTION NO. 794 LEGISLATIVE REFERENDUM NO. 371,AGAINST THE PROPOSAL - NO,550066,0,0,210,210
OKLAHOMA,STATE QUESTION NO. 794 LEGISLATIVE REFERENDUM NO. 371,FOR THE PROPOSAL - YES,550067,0,0,798,798
OKLAHOMA,STATE QUESTION NO. 794 LEGISLATIVE REFERENDUM NO. 371,AGAINST THE PROPOSAL - NO,550067,0,0,181,181
OKLAHOMA,STATE QUESTION NO. 794 LEGISLATIVE REFERENDUM NO. 371,FOR THE PROPOSAL - YES,550068,0,0,573,573
OKLAHOMA,STATE QUESTION NO. 794 LEGISLATIVE REFERENDUM NO. 371,AGAINST THE PROPOSAL - NO,550068,0,0,137,137
OKLAHOMA,STATE QUESTION NO. 794 LEGISLATIVE REFERENDUM NO. 371,FOR THE PROPOSAL - YES,550069,0,0,720,720
OKLAHOMA,STATE QUESTION NO. 794 LEGISLATIVE REFERENDUM NO. 371,AGAINST THE PROPOSAL - NO,550069,0,0,151,151
OKLAHOMA,STATE QUESTION NO. 794 LEGISLATIVE REFERENDUM NO. 371,FOR THE PROPOSAL - YES,550070,0,0,541,541
OKLAHOMA,STATE QUESTION NO. 794 LEGISLATIVE REFERENDUM NO. 371,AGAINST THE PROPOSAL - NO,550070,0,0,140,140
OKLAHOMA,STATE QUESTION NO. 794 LEGISLATIVE REFERENDUM NO. 371,FOR THE PROPOSAL - YES,550071,0,0,793,793
OKLAHOMA,STATE QUESTION NO. 794 LEGISLATIVE REFERENDUM NO. 371,AGAINST THE PROPOSAL - NO,550071,0,0,162,162
OKLAHOMA,STATE QUESTION NO. 794 LEGISLATIVE REFERENDUM NO. 371,FOR THE PROPOSAL - YES,550072,0,0,533,533
OKLAHOMA,STATE QUESTION NO. 794 LEGISLATIVE REFERENDUM NO. 371,AGAINST THE PROPOSAL - NO,550072,0,0,100,100
OKLAHOMA,STATE QUESTION NO. 794 LEGISLATIVE REFERENDUM NO. 371,FOR THE PROPOSAL - YES,550073,0,0,148,148
OKLAHOMA,STATE QUESTION NO. 794 LEGISLATIVE REFERENDUM NO. 371,AGAINST THE PROPOSAL - NO,550073,0,0,44,44
OKLAHOMA,STATE QUESTION NO. 794 LEGISLATIVE REFERENDUM NO. 371,FOR THE PROPOSAL - YES,550074,0,0,160,160
OKLAHOMA,STATE QUESTION NO. 794 LEGISLATIVE REFERENDUM NO. 371,AGAINST THE PROPOSAL - NO,550074,0,0,50,50
OKLAHOMA,STATE QUESTION NO. 794 LEGISLATIVE REFERENDUM NO. 371,FOR THE PROPOSAL - YES,550075,0,0,610,610
OKLAHOMA,STATE QUESTION NO. 794 LEGISLATIVE REFERENDUM NO. 371,AGAINST THE PROPOSAL - NO,550075,0,0,169,169
OKLAHOMA,STATE QUESTION NO. 794 LEGISLATIVE REFERENDUM NO. 371,FOR THE PROPOSAL - YES,550076,0,0,612,612
OKLAHOMA,STATE QUESTION NO. 794 LEGISLATIVE REFERENDUM NO. 371,AGAINST THE PROPOSAL - NO,550076,0,0,149,149
OKLAHOMA,STATE QUESTION NO. 794 LEGISLATIVE REFERENDUM NO. 371,FOR THE PROPOSAL - YES,550077,0,0,604,604
OKLAHOMA,STATE QUESTION NO. 794 LEGISLATIVE REFERENDUM NO. 371,AGAINST THE PROPOSAL - NO,550077,0,0,186,186
OKLAHOMA,STATE QUESTION NO. 794 LEGISLATIVE REFERENDUM NO. 371,FOR THE PROPOSAL - YES,550078,0,0,423,423
OKLAHOMA,STATE QUESTION NO. 794 LEGISLATIVE REFERENDUM NO. 371,AGAINST THE PROPOSAL - NO,550078,0,0,158,158
OKLAHOMA,STATE QUESTION NO. 794 LEGISLATIVE REFERENDUM NO. 371,FOR THE PROPOSAL - YES,550079,0,0,630,630
OKLAHOMA,STATE QUESTION NO. 794 LEGISLATIVE REFERENDUM NO. 371,AGAINST THE PROPOSAL - NO,550079,0,0,157,157
OKLAHOMA,STATE QUESTION NO. 794 LEGISLATIVE REFERENDUM NO. 371,FOR THE PROPOSAL - YES,550080,0,0,1076,1076
OKLAHOMA,STATE QUESTION NO. 794 LEGISLATIVE REFERENDUM NO. 371,AGAINST THE PROPOSAL - NO,550080,0,0,304,304
OKLAHOMA,STATE QUESTION NO. 794 LEGISLATIVE REFERENDUM NO. 371,FOR THE PROPOSAL - YES,550081,0,0,556,556
OKLAHOMA,STATE QUESTION NO. 794 LEGISLATIVE REFERENDUM NO. 371,AGAINST THE PROPOSAL - NO,550081,0,0,136,136
OKLAHOMA,STATE QUESTION NO. 794 LEGISLATIVE REFERENDUM NO. 371,FOR THE PROPOSAL - YES,550082,0,0,283,283
OKLAHOMA,STATE QUESTION NO. 794 LEGISLATIVE REFERENDUM NO. 371,AGAINST THE PROPOSAL - NO,550082,0,0,74,74
OKLAHOMA,STATE QUESTION NO. 794 LEGISLATIVE REFERENDUM NO. 371,FOR THE PROPOSAL - YES,550083,0,0,652,652
OKLAHOMA,STATE QUESTION NO. 794 LEGISLATIVE REFERENDUM NO. 371,AGAINST THE PROPOSAL - NO,550083,0,0,185,185
OKLAHOMA,STATE QUESTION NO. 794 LEGISLATIVE REFERENDUM NO. 371,FOR THE PROPOSAL - YES,550084,0,0,472,472
OKLAHOMA,STATE QUESTION NO. 794 LEGISLATIVE REFERENDUM NO. 371,AGAINST THE PROPOSAL - NO,550084,0,0,108,108
OKLAHOMA,STATE QUESTION NO. 794 LEGISLATIVE REFERENDUM NO. 371,FOR THE PROPOSAL - YES,550085,0,0,727,727
OKLAHOMA,STATE QUESTION NO. 794 LEGISLATIVE REFERENDUM NO. 371,AGAINST THE PROPOSAL - NO,550085,0,0,173,173
OKLAHOMA,STATE QUESTION NO. 794 LEGISLATIVE REFERENDUM NO. 371,FOR THE PROPOSAL - YES,550086,0,0,855,855
OKLAHOMA,STATE QUESTION NO. 794 LEGISLATIVE REFERENDUM NO. 371,AGAINST THE PROPOSAL - NO,550086,0,0,231,231
OKLAHOMA,STATE QUESTION NO. 794 LEGISLATIVE REFERENDUM NO. 371,FOR THE PROPOSAL - YES,550087,0,0,358,358
OKLAHOMA,STATE QUESTION NO. 794 LEGISLATIVE REFERENDUM NO. 371,AGAINST THE PROPOSAL - NO,550087,0,0,95,95
OKLAHOMA,STATE QUESTION NO. 794 LEGISLATIVE REFERENDUM NO. 371,FOR THE PROPOSAL - YES,550088,0,0,253,253
OKLAHOMA,STATE QUESTION NO. 794 LEGISLATIVE REFERENDUM NO. 371,AGAINST THE PROPOSAL - NO,550088,0,0,55,55
OKLAHOMA,STATE QUESTION NO. 794 LEGISLATIVE REFERENDUM NO. 371,FOR THE PROPOSAL - YES,550089,0,0,451,451
OKLAHOMA,STATE QUESTION NO. 794 LEGISLATIVE REFERENDUM NO. 371,AGAINST THE PROPOSAL - NO,550089,0,0,86,86
OKLAHOMA,STATE QUESTION NO. 794 LEGISLATIVE REFERENDUM NO. 371,FOR THE PROPOSAL - YES,550090,0,0,81,81
OKLAHOMA,STATE QUESTION NO. 794 LEGISLATIVE REFERENDUM NO. 371,AGAINST THE PROPOSAL - NO,550090,0,0,33,33
OKLAHOMA,STATE QUESTION NO. 794 LEGISLATIVE REFERENDUM NO. 371,FOR THE PROPOSAL - YES,550091,0,0,129,129
OKLAHOMA,STATE QUESTION NO. 794 LEGISLATIVE REFERENDUM NO. 371,AGAINST THE PROPOSAL - NO,550091,0,0,34,34
OKLAHOMA,STATE QUESTION NO. 794 LEGISLATIVE REFERENDUM NO. 371,FOR THE PROPOSAL - YES,550092,0,0,989,989
OKLAHOMA,STATE QUESTION NO. 794 LEGISLATIVE REFERENDUM NO. 371,AGAINST THE PROPOSAL - NO,550092,0,0,208,208
OKLAHOMA,STATE QUESTION NO. 794 LEGISLATIVE REFERENDUM NO. 371,FOR THE PROPOSAL - YES,550093,0,0,490,490
OKLAHOMA,STATE QUESTION NO. 794 LEGISLATIVE REFERENDUM NO. 371,AGAINST THE PROPOSAL - NO,550093,0,0,126,126
OKLAHOMA,STATE QUESTION NO. 794 LEGISLATIVE REFERENDUM NO. 371,FOR THE PROPOSAL - YES,550094,0,0,792,792
OKLAHOMA,STATE QUESTION NO. 794 LEGISLATIVE REFERENDUM NO. 371,AGAINST THE PROPOSAL - NO,550094,0,0,175,175
OKLAHOMA,STATE QUESTION NO. 794 LEGISLATIVE REFERENDUM NO. 371,FOR THE PROPOSAL - YES,550095,0,0,587,587
OKLAHOMA,STATE QUESTION NO. 794 LEGISLATIVE REFERENDUM NO. 371,AGAINST THE PROPOSAL - NO,550095,0,0,145,145
OKLAHOMA,STATE QUESTION NO. 794 LEGISLATIVE REFERENDUM NO. 371,FOR THE PROPOSAL - YES,550096,0,0,781,781
OKLAHOMA,STATE QUESTION NO. 794 LEGISLATIVE REFERENDUM NO. 371,AGAINST THE PROPOSAL - NO,550096,0,0,186,186
OKLAHOMA,STATE QUESTION NO. 794 LEGISLATIVE REFERENDUM NO. 371,FOR THE PROPOSAL - YES,550097,0,0,557,557
OKLAHOMA,STATE QUESTION NO. 794 LEGISLATIVE REFERENDUM NO. 371,AGAINST THE PROPOSAL - NO,550097,0,0,122,122
OKLAHOMA,STATE QUESTION NO. 794 LEGISLATIVE REFERENDUM NO. 371,FOR THE PROPOSAL - YES,550098,0,0,1103,1103
OKLAHOMA,STATE QUESTION NO. 794 LEGISLATIVE REFERENDUM NO. 371,AGAINST THE PROPOSAL - NO,550098,0,0,275,275
OKLAHOMA,STATE QUESTION NO. 794 LEGISLATIVE REFERENDUM NO. 371,FOR THE PROPOSAL - YES,550099,0,0,691,691
OKLAHOMA,STATE QUESTION NO. 794 LEGISLATIVE REFERENDUM NO. 371,AGAINST THE PROPOSAL - NO,550099,0,0,235,235
OKLAHOMA,STATE QUESTION NO. 794 LEGISLATIVE REFERENDUM NO. 371,FOR THE PROPOSAL - YES,550100,0,0,787,787
OKLAHOMA,STATE QUESTION NO. 794 LEGISLATIVE REFERENDUM NO. 371,AGAINST THE PROPOSAL - NO,550100,0,0,251,251
OKLAHOMA,STATE QUESTION NO. 794 LEGISLATIVE REFERENDUM NO. 371,FOR THE PROPOSAL - YES,550101,0,0,298,298
OKLAHOMA,STATE QUESTION NO. 794 LEGISLATIVE REFERENDUM NO. 371,AGAINST THE PROPOSAL - NO,550101,0,0,120,120
OKLAHOMA,STATE QUESTION NO. 794 LEGISLATIVE REFERENDUM NO. 371,FOR THE PROPOSAL - YES,550102,0,0,860,860
OKLAHOMA,STATE QUESTION NO. 794 LEGISLATIVE REFERENDUM NO. 371,AGAINST THE PROPOSAL - NO,550102,0,0,294,294
OKLAHOMA,STATE QUESTION NO. 794 LEGISLATIVE REFERENDUM NO. 371,FOR THE PROPOSAL - YES,550103,0,0,543,543
OKLAHOMA,STATE QUESTION NO. 794 LEGISLATIVE REFERENDUM NO. 371,AGAINST THE PROPOSAL - NO,550103,0,0,189,189
OKLAHOMA,STATE QUESTION NO. 794 LEGISLATIVE REFERENDUM NO. 371,FOR THE PROPOSAL - YES,550104,0,0,449,449
OKLAHOMA,STATE QUESTION NO. 794 LEGISLATIVE REFERENDUM NO. 371,AGAINST THE PROPOSAL - NO,550104,0,0,156,156
OKLAHOMA,STATE QUESTION NO. 794 LEGISLATIVE REFERENDUM NO. 371,FOR THE PROPOSAL - YES,550105,0,0,662,662
OKLAHOMA,STATE QUESTION NO. 794 LEGISLATIVE REFERENDUM NO. 371,AGAINST THE PROPOSAL - NO,550105,0,0,210,210
OKLAHOMA,STATE QUESTION NO. 794 LEGISLATIVE REFERENDUM NO. 371,FOR THE PROPOSAL - YES,550106,0,0,770,770
OKLAHOMA,STATE QUESTION NO. 794 LEGISLATIVE REFERENDUM NO. 371,AGAINST THE PROPOSAL - NO,550106,0,0,251,251
OKLAHOMA,STATE QUESTION NO. 794 LEGISLATIVE REFERENDUM NO. 371,FOR THE PROPOSAL - YES,550107,0,0,283,283
OKLAHOMA,STATE QUESTION NO. 794 LEGISLATIVE REFERENDUM NO. 371,AGAINST THE PROPOSAL - NO,550107,0,0,64,64
OKLAHOMA,STATE QUESTION NO. 794 LEGISLATIVE REFERENDUM NO. 371,FOR THE PROPOSAL - YES,550108,0,0,225,225
OKLAHOMA,STATE QUESTION NO. 794 LEGISLATIVE REFERENDUM NO. 371,AGAINST THE PROPOSAL - NO,550108,0,0,47,47
OKLAHOMA,STATE QUESTION NO. 794 LEGISLATIVE REFERENDUM NO. 371,FOR THE PROPOSAL - YES,550109,0,0,1069,1069
OKLAHOMA,STATE QUESTION NO. 794 LEGISLATIVE REFERENDUM NO. 371,AGAINST THE PROPOSAL - NO,550109,0,0,289,289
OKLAHOMA,STATE QUESTION NO. 794 LEGISLATIVE REFERENDUM NO. 371,FOR THE PROPOSAL - YES,550110,0,0,296,296
OKLAHOMA,STATE QUESTION NO. 794 LEGISLATIVE REFERENDUM NO. 371,AGAINST THE PROPOSAL - NO,550110,0,0,79,79
OKLAHOMA,STATE QUESTION NO. 794 LEGISLATIVE REFERENDUM NO. 371,FOR THE PROPOSAL - YES,550111,0,0,1012,1012
OKLAHOMA,STATE QUESTION NO. 794 LEGISLATIVE REFERENDUM NO. 371,AGAINST THE PROPOSAL - NO,550111,0,0,244,244
OKLAHOMA,STATE QUESTION NO. 794 LEGISLATIVE REFERENDUM NO. 371,FOR THE PROPOSAL - YES,550112,0,0,100,100
OKLAHOMA,STATE QUESTION NO. 794 LEGISLATIVE REFERENDUM NO. 371,AGAINST THE PROPOSAL - NO,550112,0,0,29,29
OKLAHOMA,STATE QUESTION NO. 794 LEGISLATIVE REFERENDUM NO. 371,FOR THE PROPOSAL - YES,550113,0,0,174,174
OKLAHOMA,STATE QUESTION NO. 794 LEGISLATIVE REFERENDUM NO. 371,AGAINST THE PROPOSAL - NO,550113,0,0,59,59
OKLAHOMA,STATE QUESTION NO. 794 LEGISLATIVE REFERENDUM NO. 371,FOR THE PROPOSAL - YES,550114,0,0,488,488
OKLAHOMA,STATE QUESTION NO. 794 LEGISLATIVE REFERENDUM NO. 371,AGAINST THE PROPOSAL - NO,550114,0,0,136,136
OKLAHOMA,STATE QUESTION NO. 794 LEGISLATIVE REFERENDUM NO. 371,FOR THE PROPOSAL - YES,550115,0,0,635,635
OKLAHOMA,STATE QUESTION NO. 794 LEGISLATIVE REFERENDUM NO. 371,AGAINST THE PROPOSAL - NO,550115,0,0,210,210
OKLAHOMA,STATE QUESTION NO. 794 LEGISLATIVE REFERENDUM NO. 371,FOR THE PROPOSAL - YES,550116,0,0,257,257
OKLAHOMA,STATE QUESTION NO. 794 LEGISLATIVE REFERENDUM NO. 371,AGAINST THE PROPOSAL - NO,550116,0,0,125,125
OKLAHOMA,STATE QUESTION NO. 794 LEGISLATIVE REFERENDUM NO. 371,FOR THE PROPOSAL - YES,550117,0,0,785,785
OKLAHOMA,STATE QUESTION NO. 794 LEGISLATIVE REFERENDUM NO. 371,AGAINST THE PROPOSAL - NO,550117,0,0,221,221
OKLAHOMA,STATE QUESTION NO. 794 LEGISLATIVE REFERENDUM NO. 371,FOR THE PROPOSAL - YES,550118,0,0,666,666
OKLAHOMA,STATE QUESTION NO. 794 LEGISLATIVE REFERENDUM NO. 371,AGAINST THE PROPOSAL - NO,550118,0,0,204,204
OKLAHOMA,STATE QUESTION NO. 794 LEGISLATIVE REFERENDUM NO. 371,FOR THE PROPOSAL - YES,550119,0,0,125,125
OKLAHOMA,STATE QUESTION NO. 794 LEGISLATIVE REFERENDUM NO. 371,AGAINST THE PROPOSAL - NO,550119,0,0,41,41
OKLAHOMA,STATE QUESTION NO. 794 LEGISLATIVE REFERENDUM NO. 371,FOR THE PROPOSAL - YES,550120,0,0,595,595
OKLAHOMA,STATE QUESTION NO. 794 LEGISLATIVE REFERENDUM NO. 371,AGAINST THE PROPOSAL - NO,550120,0,0,149,149
OKLAHOMA,STATE QUESTION NO. 794 LEGISLATIVE REFERENDUM NO. 371,FOR THE PROPOSAL - YES,550121,0,0,833,833
OKLAHOMA,STATE QUESTION NO. 794 LEGISLATIVE REFERENDUM NO. 371,AGAINST THE PROPOSAL - NO,550121,0,0,236,236
OKLAHOMA,STATE QUESTION NO. 794 LEGISLATIVE REFERENDUM NO. 371,FOR THE PROPOSAL - YES,550122,0,0,601,601
OKLAHOMA,STATE QUESTION NO. 794 LEGISLATIVE REFERENDUM NO. 371,AGAINST THE PROPOSAL - NO,550122,0,0,171,171
OKLAHOMA,STATE QUESTION NO. 794 LEGISLATIVE REFERENDUM NO. 371,FOR THE PROPOSAL - YES,550123,0,0,641,641
OKLAHOMA,STATE QUESTION NO. 794 LEGISLATIVE REFERENDUM NO. 371,AGAINST THE PROPOSAL - NO,550123,0,0,183,183
OKLAHOMA,STATE QUESTION NO. 794 LEGISLATIVE REFERENDUM NO. 371,FOR THE PROPOSAL - YES,550124,0,0,577,577
OKLAHOMA,STATE QUESTION NO. 794 LEGISLATIVE REFERENDUM NO. 371,AGAINST THE PROPOSAL - NO,550124,0,0,151,151
OKLAHOMA,STATE QUESTION NO. 794 LEGISLATIVE REFERENDUM NO. 371,FOR THE PROPOSAL - YES,550125,0,0,308,308
OKLAHOMA,STATE QUESTION NO. 794 LEGISLATIVE REFERENDUM NO. 371,AGAINST THE PROPOSAL - NO,550125,0,0,66,66
OKLAHOMA,STATE QUESTION NO. 794 LEGISLATIVE REFERENDUM NO. 371,FOR THE PROPOSAL - YES,550126,0,0,604,604
OKLAHOMA,STATE QUESTION NO. 794 LEGISLATIVE REFERENDUM NO. 371,AGAINST THE PROPOSAL - NO,550126,0,0,174,174
OKLAHOMA,STATE QUESTION NO. 794 LEGISLATIVE REFERENDUM NO. 371,FOR THE PROPOSAL - YES,550127,0,0,767,767
OKLAHOMA,STATE QUESTION NO. 794 LEGISLATIVE REFERENDUM NO. 371,AGAINST THE PROPOSAL - NO,550127,0,0,233,233
OKLAHOMA,STATE QUESTION NO. 794 LEGISLATIVE REFERENDUM NO. 371,FOR THE PROPOSAL - YES,550128,0,0,733,733
OKLAHOMA,STATE QUESTION NO. 794 LEGISLATIVE REFERENDUM NO. 371,AGAINST THE PROPOSAL - NO,550128,0,0,215,215
OKLAHOMA,STATE QUESTION NO. 794 LEGISLATIVE REFERENDUM NO. 371,FOR THE PROPOSAL - YES,550129,0,0,447,447
OKLAHOMA,STATE QUESTION NO. 794 LEGISLATIVE REFERENDUM NO. 371,AGAINST THE PROPOSAL - NO,550129,0,0,128,128
OKLAHOMA,STATE QUESTION NO. 794 LEGISLATIVE REFERENDUM NO. 371,FOR THE PROPOSAL - YES,550130,0,0,1093,1093
OKLAHOMA,STATE QUESTION NO. 794 LEGISLATIVE REFERENDUM NO. 371,AGAINST THE PROPOSAL - NO,550130,0,0,315,315
OKLAHOMA,STATE QUESTION NO. 794 LEGISLATIVE REFERENDUM NO. 371,FOR THE PROPOSAL - YES,550131,0,0,525,525
OKLAHOMA,STATE QUESTION NO. 794 LEGISLATIVE REFERENDUM NO. 371,AGAINST THE PROPOSAL - NO,550131,0,0,163,163
OKLAHOMA,STATE QUESTION NO. 794 LEGISLATIVE REFERENDUM NO. 371,FOR THE PROPOSAL - YES,550132,0,0,635,635
OKLAHOMA,STATE QUESTION NO. 794 LEGISLATIVE REFERENDUM NO. 371,AGAINST THE PROPOSAL - NO,550132,0,0,172,172
OKLAHOMA,STATE QUESTION NO. 794 LEGISLATIVE REFERENDUM NO. 371,FOR THE PROPOSAL - YES,550133,0,0,707,707
OKLAHOMA,STATE QUESTION NO. 794 LEGISLATIVE REFERENDUM NO. 371,AGAINST THE PROPOSAL - NO,550133,0,0,213,213
OKLAHOMA,STATE QUESTION NO. 794 LEGISLATIVE REFERENDUM NO. 371,FOR THE PROPOSAL - YES,550134,0,0,1286,1286
OKLAHOMA,STATE QUESTION NO. 794 LEGISLATIVE REFERENDUM NO. 371,AGAINST THE PROPOSAL - NO,550134,0,0,363,363
OKLAHOMA,STATE QUESTION NO. 794 LEGISLATIVE REFERENDUM NO. 371,FOR THE PROPOSAL - YES,550135,0,0,448,448
OKLAHOMA,STATE QUESTION NO. 794 LEGISLATIVE REFERENDUM NO. 371,AGAINST THE PROPOSAL - NO,550135,0,0,128,128
OKLAHOMA,STATE QUESTION NO. 794 LEGISLATIVE REFERENDUM NO. 371,FOR THE PROPOSAL - YES,550136,0,0,1461,1461
OKLAHOMA,STATE QUESTION NO. 794 LEGISLATIVE REFERENDUM NO. 371,AGAINST THE PROPOSAL - NO,550136,0,0,399,399
OKLAHOMA,STATE QUESTION NO. 794 LEGISLATIVE REFERENDUM NO. 371,FOR THE PROPOSAL - YES,550137,0,0,1157,1157
OKLAHOMA,STATE QUESTION NO. 794 LEGISLATIVE REFERENDUM NO. 371,AGAINST THE PROPOSAL - NO,550137,0,0,349,349
OKLAHOMA,STATE QUESTION NO. 794 LEGISLATIVE REFERENDUM NO. 371,FOR THE PROPOSAL - YES,550138,0,0,420,420
OKLAHOMA,STATE QUESTION NO. 794 LEGISLATIVE REFERENDUM NO. 371,AGAINST THE PROPOSAL - NO,550138,0,0,139,139
OKLAHOMA,STATE QUESTION NO. 794 LEGISLATIVE REFERENDUM NO. 371,FOR THE PROPOSAL - YES,550139,0,0,1753,1753
OKLAHOMA,STATE QUESTION NO. 794 LEGISLATIVE REFERENDUM NO. 371,AGAINST THE PROPOSAL - NO,550139,0,0,491,491
OKLAHOMA,STATE QUESTION NO. 794 LEGISLATIVE REFERENDUM NO. 371,FOR THE PROPOSAL - YES,550140,0,0,646,646
OKLAHOMA,STATE QUESTION NO. 794 LEGISLATIVE REFERENDUM NO. 371,AGAINST THE PROPOSAL - NO,550140,0,0,158,158
OKLAHOMA,STATE QUESTION NO. 794 LEGISLATIVE REFERENDUM NO. 371,FOR THE PROPOSAL - YES,550141,0,0,1265,1265
OKLAHOMA,STATE QUESTION NO. 794 LEGISLATIVE REFERENDUM NO. 371,AGAINST THE PROPOSAL - NO,550141,0,0,346,346
OKLAHOMA,STATE QUESTION NO. 794 LEGISLATIVE REFERENDUM NO. 371,FOR THE PROPOSAL - YES,550142,0,0,1218,1218
OKLAHOMA,STATE QUESTION NO. 794 LEGISLATIVE REFERENDUM NO. 371,AGAINST THE PROPOSAL - NO,550142,0,0,332,332
OKLAHOMA,STATE QUESTION NO. 794 LEGISLATIVE REFERENDUM NO. 371,FOR THE PROPOSAL - YES,550143,0,0,727,727
OKLAHOMA,STATE QUESTION NO. 794 LEGISLATIVE REFERENDUM NO. 371,AGAINST THE PROPOSAL - NO,550143,0,0,157,157
OKLAHOMA,STATE QUESTION NO. 794 LEGISLATIVE REFERENDUM NO. 371,FOR THE PROPOSAL - YES,550144,0,0,696,696
OKLAHOMA,STATE QUESTION NO. 794 LEGISLATIVE REFERENDUM NO. 371,AGAINST THE PROPOSAL - NO,550144,0,0,222,222
OKLAHOMA,STATE QUESTION NO. 794 LEGISLATIVE REFERENDUM NO. 371,FOR THE PROPOSAL - YES,550145,0,0,693,693
OKLAHOMA,STATE QUESTION NO. 794 LEGISLATIVE REFERENDUM NO. 371,AGAINST THE PROPOSAL - NO,550145,0,0,179,179
OKLAHOMA,STATE QUESTION NO. 794 LEGISLATIVE REFERENDUM NO. 371,FOR THE PROPOSAL - YES,550146,0,0,931,931
OKLAHOMA,STATE QUESTION NO. 794 LEGISLATIVE REFERENDUM NO. 371,AGAINST THE PROPOSAL - NO,550146,0,0,306,306
OKLAHOMA,STATE QUESTION NO. 794 LEGISLATIVE REFERENDUM NO. 371,FOR THE PROPOSAL - YES,550147,0,0,320,320
OKLAHOMA,STATE QUESTION NO. 794 LEGISLATIVE REFERENDUM NO. 371,AGAINST THE PROPOSAL - NO,550147,0,0,70,70
OKLAHOMA,STATE QUESTION NO. 794 LEGISLATIVE REFERENDUM NO. 371,FOR THE PROPOSAL - YES,550148,0,0,1080,1080
OKLAHOMA,STATE QUESTION NO. 794 LEGISLATIVE REFERENDUM NO. 371,AGAINST THE PROPOSAL - NO,550148,0,0,245,245
OKLAHOMA,STATE QUESTION NO. 794 LEGISLATIVE REFERENDUM NO. 371,FOR THE PROPOSAL - YES,550149,0,0,992,992
OKLAHOMA,STATE QUESTION NO. 794 LEGISLATIVE REFERENDUM NO. 371,AGAINST THE PROPOSAL - NO,550149,0,0,249,249
OKLAHOMA,STATE QUESTION NO. 794 LEGISLATIVE REFERENDUM NO. 371,FOR THE PROPOSAL - YES,550150,0,0,1057,1057
OKLAHOMA,STATE QUESTION NO. 794 LEGISLATIVE REFERENDUM NO. 371,AGAINST THE PROPOSAL - NO,550150,0,0,264,264
OKLAHOMA,STATE QUESTION NO. 794 LEGISLATIVE REFERENDUM NO. 371,FOR THE PROPOSAL - YES,550151,0,0,1122,1122
OKLAHOMA,STATE QUESTION NO. 794 LEGISLATIVE REFERENDUM NO. 371,AGAINST THE PROPOSAL - NO,550151,0,0,313,313
OKLAHOMA,STATE QUESTION NO. 794 LEGISLATIVE REFERENDUM NO. 371,FOR THE PROPOSAL - YES,550152,0,0,1037,1037
OKLAHOMA,STATE QUESTION NO. 794 LEGISLATIVE REFERENDUM NO. 371,AGAINST THE PROPOSAL - NO,550152,0,0,283,283
OKLAHOMA,STATE QUESTION NO. 794 LEGISLATIVE REFERENDUM NO. 371,FOR THE PROPOSAL - YES,550153,0,0,1114,1114
OKLAHOMA,STATE QUESTION NO. 794 LEGISLATIVE REFERENDUM NO. 371,AGAINST THE PROPOSAL - NO,550153,0,0,260,260
OKLAHOMA,STATE QUESTION NO. 794 LEGISLATIVE REFERENDUM NO. 371,FOR THE PROPOSAL - YES,550154,0,0,1197,1197
OKLAHOMA,STATE QUESTION NO. 794 LEGISLATIVE REFERENDUM NO. 371,AGAINST THE PROPOSAL - NO,550154,0,0,370,370
OKLAHOMA,STATE QUESTION NO. 794 LEGISLATIVE REFERENDUM NO. 371,FOR THE PROPOSAL - YES,550155,0,0,343,343
OKLAHOMA,STATE QUESTION NO. 794 LEGISLATIVE REFERENDUM NO. 371,AGAINST THE PROPOSAL - NO,550155,0,0,85,85
OKLAHOMA,STATE QUESTION NO. 794 LEGISLATIVE REFERENDUM NO. 371,FOR THE PROPOSAL - YES,550156,0,0,993,993
OKLAHOMA,STATE QUESTION NO. 794 LEGISLATIVE REFERENDUM NO. 371,AGAINST THE PROPOSAL - NO,550156,0,0,275,275
OKLAHOMA,STATE QUESTION NO. 794 LEGISLATIVE REFERENDUM NO. 371,FOR THE PROPOSAL - YES,550157,0,0,26,26
OKLAHOMA,STATE QUESTION NO. 794 LEGISLATIVE REFERENDUM NO. 371,AGAINST THE PROPOSAL - NO,550157,0,0,9,9
OKLAHOMA,STATE QUESTION NO. 794 LEGISLATIVE REFERENDUM NO. 371,FOR THE PROPOSAL - YES,550158,0,0,760,760
OKLAHOMA,STATE QUESTION NO. 794 LEGISLATIVE REFERENDUM NO. 371,AGAINST THE PROPOSAL - NO,550158,0,0,188,188
OKLAHOMA,STATE QUESTION NO. 794 LEGISLATIVE REFERENDUM NO. 371,FOR THE PROPOSAL - YES,550159,0,0,933,933
OKLAHOMA,STATE QUESTION NO. 794 LEGISLATIVE REFERENDUM NO. 371,AGAINST THE PROPOSAL - NO,550159,0,0,273,273
OKLAHOMA,STATE QUESTION NO. 794 LEGISLATIVE REFERENDUM NO. 371,FOR THE PROPOSAL - YES,550160,0,0,875,875
OKLAHOMA,STATE QUESTION NO. 794 LEGISLATIVE REFERENDUM NO. 371,AGAINST THE PROPOSAL - NO,550160,0,0,210,210
OKLAHOMA,STATE QUESTION NO. 794 LEGISLATIVE REFERENDUM NO. 371,FOR THE PROPOSAL - YES,550161,0,0,573,573
OKLAHOMA,STATE QUESTION NO. 794 LEGISLATIVE REFERENDUM NO. 371,AGAINST THE PROPOSAL - NO,550161,0,0,142,142
OKLAHOMA,STATE QUESTION NO. 794 LEGISLATIVE REFERENDUM NO. 371,FOR THE PROPOSAL - YES,550162,0,0,576,576
OKLAHOMA,STATE QUESTION NO. 794 LEGISLATIVE REFERENDUM NO. 371,AGAINST THE PROPOSAL - NO,550162,0,0,154,154
OKLAHOMA,STATE QUESTION NO. 794 LEGISLATIVE REFERENDUM NO. 371,FOR THE PROPOSAL - YES,550163,0,0,668,668
OKLAHOMA,STATE QUESTION NO. 794 LEGISLATIVE REFERENDUM NO. 371,AGAINST THE PROPOSAL - NO,550163,0,0,134,134
OKLAHOMA,STATE QUESTION NO. 794 LEGISLATIVE REFERENDUM NO. 371,FOR THE PROPOSAL - YES,550164,0,0,468,468
OKLAHOMA,STATE QUESTION NO. 794 LEGISLATIVE REFERENDUM NO. 371,AGAINST THE PROPOSAL - NO,550164,0,0,120,120
OKLAHOMA,STATE QUESTION NO. 794 LEGISLATIVE REFERENDUM NO. 371,FOR THE PROPOSAL - YES,550165,0,0,888,888
OKLAHOMA,STATE QUESTION NO. 794 LEGISLATIVE REFERENDUM NO. 371,AGAINST THE PROPOSAL - NO,550165,0,0,221,221
OKLAHOMA,STATE QUESTION NO. 794 LEGISLATIVE REFERENDUM NO. 371,FOR THE PROPOSAL - YES,550166,0,0,165,165
OKLAHOMA,STATE QUESTION NO. 794 LEGISLATIVE REFERENDUM NO. 371,AGAINST THE PROPOSAL - NO,550166,0,0,39,39
OKLAHOMA,STATE QUESTION NO. 794 LEGISLATIVE REFERENDUM NO. 371,FOR THE PROPOSAL - YES,550167,0,0,276,276
OKLAHOMA,STATE QUESTION NO. 794 LEGISLATIVE REFERENDUM NO. 371,AGAINST THE PROPOSAL - NO,550167,0,0,62,62
OKLAHOMA,STATE QUESTION NO. 794 LEGISLATIVE REFERENDUM NO. 371,FOR THE PROPOSAL - YES,550168,0,0,152,152
OKLAHOMA,STATE QUESTION NO. 794 LEGISLATIVE REFERENDUM NO. 371,AGAINST THE PROPOSAL - NO,550168,0,0,38,38
OKLAHOMA,STATE QUESTION NO. 794 LEGISLATIVE REFERENDUM NO. 371,FOR THE PROPOSAL - YES,550169,0,0,518,518
OKLAHOMA,STATE QUESTION NO. 794 LEGISLATIVE REFERENDUM NO. 371,AGAINST THE PROPOSAL - NO,550169,0,0,139,139
OKLAHOMA,STATE QUESTION NO. 794 LEGISLATIVE REFERENDUM NO. 371,FOR THE PROPOSAL - YES,550170,0,0,454,454
OKLAHOMA,STATE QUESTION NO. 794 LEGISLATIVE REFERENDUM NO. 371,AGAINST THE PROPOSAL - NO,550170,0,0,132,132
OKLAHOMA,STATE QUESTION NO. 794 LEGISLATIVE REFERENDUM NO. 371,FOR THE PROPOSAL - YES,550171,0,0,592,592
OKLAHOMA,STATE QUESTION NO. 794 LEGISLATIVE REFERENDUM NO. 371,AGAINST THE PROPOSAL - NO,550171,0,0,222,222
OKLAHOMA,STATE QUESTION NO. 794 LEGISLATIVE REFERENDUM NO. 371,FOR THE PROPOSAL - YES,550172,0,0,697,697
OKLAHOMA,STATE QUESTION NO. 794 LEGISLATIVE REFERENDUM NO. 371,AGAINST THE PROPOSAL - NO,550172,0,0,190,190
OKLAHOMA,STATE QUESTION NO. 794 LEGISLATIVE REFERENDUM NO. 371,FOR THE PROPOSAL - YES,550173,0,0,751,751
OKLAHOMA,STATE QUESTION NO. 794 LEGISLATIVE REFERENDUM NO. 371,AGAINST THE PROPOSAL - NO,550173,0,0,197,197
OKLAHOMA,STATE QUESTION NO. 794 LEGISLATIVE REFERENDUM NO. 371,FOR THE PROPOSAL - YES,550174,0,0,379,379
OKLAHOMA,STATE QUESTION NO. 794 LEGISLATIVE REFERENDUM NO. 371,AGAINST THE PROPOSAL - NO,550174,0,0,130,130
OKLAHOMA,STATE QUESTION NO. 794 LEGISLATIVE REFERENDUM NO. 371,FOR THE PROPOSAL - YES,550175,0,0,238,238
OKLAHOMA,STATE QUESTION NO. 794 LEGISLATIVE REFERENDUM NO. 371,AGAINST THE PROPOSAL - NO,550175,0,0,71,71
OKLAHOMA,STATE QUESTION NO. 794 LEGISLATIVE REFERENDUM NO. 371,FOR THE PROPOSAL - YES,550176,0,0,630,630
OKLAHOMA,STATE QUESTION NO. 794 LEGISLATIVE REFERENDUM NO. 371,AGAINST THE PROPOSAL - NO,550176,0,0,186,186
OKLAHOMA,STATE QUESTION NO. 794 LEGISLATIVE REFERENDUM NO. 371,FOR THE PROPOSAL - YES,550177,0,0,660,660
OKLAHOMA,STATE QUESTION NO. 794 LEGISLATIVE REFERENDUM NO. 371,AGAINST THE PROPOSAL - NO,550177,0,0,205,205
OKLAHOMA,STATE QUESTION NO. 794 LEGISLATIVE REFERENDUM NO. 371,FOR THE PROPOSAL - YES,550178,0,0,498,498
OKLAHOMA,STATE QUESTION NO. 794 LEGISLATIVE REFERENDUM NO. 371,AGAINST THE PROPOSAL - NO,550178,0,0,160,160
OKLAHOMA,STATE QUESTION NO. 794 LEGISLATIVE REFERENDUM NO. 371,FOR THE PROPOSAL - YES,550179,0,0,725,725
OKLAHOMA,STATE QUESTION NO. 794 LEGISLATIVE REFERENDUM NO. 371,AGAINST THE PROPOSAL - NO,550179,0,0,248,248
OKLAHOMA,STATE QUESTION NO. 794 LEGISLATIVE REFERENDUM NO. 371,FOR THE PROPOSAL - YES,550180,0,0,436,436
OKLAHOMA,STATE QUESTION NO. 794 LEGISLATIVE REFERENDUM NO. 371,AGAINST THE PROPOSAL - NO,550180,0,0,173,173
OKLAHOMA,STATE QUESTION NO. 794 LEGISLATIVE REFERENDUM NO. 371,FOR THE PROPOSAL - YES,550181,0,0,299,299
OKLAHOMA,STATE QUESTION NO. 794 LEGISLATIVE REFERENDUM NO. 371,AGAINST THE PROPOSAL - NO,550181,0,0,118,118
OKLAHOMA,STATE QUESTION NO. 794 LEGISLATIVE REFERENDUM NO. 371,FOR THE PROPOSAL - YES,550182,0,0,320,320
OKLAHOMA,STATE QUESTION NO. 794 LEGISLATIVE REFERENDUM NO. 371,AGAINST THE PROPOSAL - NO,550182,0,0,101,101
OKLAHOMA,STATE QUESTION NO. 794 LEGISLATIVE REFERENDUM NO. 371,FOR THE PROPOSAL - YES,550183,0,0,602,602
OKLAHOMA,STATE QUESTION NO. 794 LEGISLATIVE REFERENDUM NO. 371,AGAINST THE PROPOSAL - NO,550183,0,0,221,221
OKLAHOMA,STATE QUESTION NO. 794 LEGISLATIVE REFERENDUM NO. 371,FOR THE PROPOSAL - YES,550184,0,0,673,673
OKLAHOMA,STATE QUESTION NO. 794 LEGISLATIVE REFERENDUM NO. 371,AGAINST THE PROPOSAL - NO,550184,0,0,223,223
OKLAHOMA,STATE QUESTION NO. 794 LEGISLATIVE REFERENDUM NO. 371,FOR THE PROPOSAL - YES,550185,0,0,211,211
OKLAHOMA,STATE QUESTION NO. 794 LEGISLATIVE REFERENDUM NO. 371,AGAINST THE PROPOSAL - NO,550185,0,0,98,98
OKLAHOMA,STATE QUESTION NO. 794 LEGISLATIVE REFERENDUM NO. 371,FOR THE PROPOSAL - YES,550186,0,0,340,340
OKLAHOMA,STATE QUESTION NO. 794 LEGISLATIVE REFERENDUM NO. 371,AGAINST THE PROPOSAL - NO,550186,0,0,171,171
OKLAHOMA,STATE QUESTION NO. 794 LEGISLATIVE REFERENDUM NO. 371,FOR THE PROPOSAL - YES,550187,0,0,62,62
OKLAHOMA,STATE QUESTION NO. 794 LEGISLATIVE REFERENDUM NO. 371,AGAINST THE PROPOSAL - NO,550187,0,0,27,27
OKLAHOMA,STATE QUESTION NO. 794 LEGISLATIVE REFERENDUM NO. 371,FOR THE PROPOSAL - YES,550188,0,0,3,3
OKLAHOMA,STATE QUESTION NO. 794 LEGISLATIVE REFERENDUM NO. 371,AGAINST THE PROPOSAL - NO,550188,0,0,0,0
OKLAHOMA,STATE QUESTION NO. 794 LEGISLATIVE REFERENDUM NO. 371,FOR THE PROPOSAL - YES,550189,0,0,82,82
OKLAHOMA,STATE QUESTION NO. 794 LEGISLATIVE REFERENDUM NO. 371,AGAINST THE PROPOSAL - NO,550189,0,0,25,25
OKLAHOMA,STATE QUESTION NO. 794 LEGISLATIVE REFERENDUM NO. 371,FOR THE PROPOSAL - YES,550190,0,0,247,247
OKLAHOMA,STATE QUESTION NO. 794 LEGISLATIVE REFERENDUM NO. 371,AGAINST THE PROPOSAL - NO,550190,0,0,121,121
OKLAHOMA,STATE QUESTION NO. 794 LEGISLATIVE REFERENDUM NO. 371,FOR THE PROPOSAL - YES,550191,0,0,355,355
OKLAHOMA,STATE QUESTION NO. 794 LEGISLATIVE REFERENDUM NO. 371,AGAINST THE PROPOSAL - NO,550191,0,0,200,200
OKLAHOMA,STATE QUESTION NO. 794 LEGISLATIVE REFERENDUM NO. 371,FOR THE PROPOSAL - YES,550192,0,0,731,731
OKLAHOMA,STATE QUESTION NO. 794 LEGISLATIVE REFERENDUM NO. 371,AGAINST THE PROPOSAL - NO,550192,0,0,394,394
OKLAHOMA,STATE QUESTION NO. 794 LEGISLATIVE REFERENDUM NO. 371,FOR THE PROPOSAL - YES,550193,0,0,439,439
OKLAHOMA,STATE QUESTION NO. 794 LEGISLATIVE REFERENDUM NO. 371,AGAINST THE PROPOSAL - NO,550193,0,0,291,291
OKLAHOMA,STATE QUESTION NO. 794 LEGISLATIVE REFERENDUM NO. 371,FOR THE PROPOSAL - YES,550194,0,0,480,480
OKLAHOMA,STATE QUESTION NO. 794 LEGISLATIVE REFERENDUM NO. 371,AGAINST THE PROPOSAL - NO,550194,0,0,212,212
OKLAHOMA,STATE QUESTION NO. 794 LEGISLATIVE REFERENDUM NO. 371,FOR THE PROPOSAL - YES,550195,0,0,856,856
OKLAHOMA,STATE QUESTION NO. 794 LEGISLATIVE REFERENDUM NO. 371,AGAINST THE PROPOSAL - NO,550195,0,0,374,374
OKLAHOMA,STATE QUESTION NO. 794 LEGISLATIVE REFERENDUM NO. 371,FOR THE PROPOSAL - YES,550196,0,0,957,957
OKLAHOMA,STATE QUESTION NO. 794 LEGISLATIVE REFERENDUM NO. 371,AGAINST THE PROPOSAL - NO,550196,0,0,401,401
OKLAHOMA,STATE QUESTION NO. 794 LEGISLATIVE REFERENDUM NO. 371,FOR THE PROPOSAL - YES,550197,0,0,494,494
OKLAHOMA,STATE QUESTION NO. 794 LEGISLATIVE REFERENDUM NO. 371,AGAINST THE PROPOSAL - NO,550197,0,0,253,253
OKLAHOMA,STATE QUESTION NO. 794 LEGISLATIVE REFERENDUM NO. 371,FOR THE PROPOSAL - YES,550198,0,0,475,475
OKLAHOMA,STATE QUESTION NO. 794 LEGISLATIVE REFERENDUM NO. 371,AGAINST THE PROPOSAL - NO,550198,0,0,296,296
OKLAHOMA,STATE QUESTION NO. 794 LEGISLATIVE REFERENDUM NO. 371,FOR THE PROPOSAL - YES,550199,0,0,476,476
OKLAHOMA,STATE QUESTION NO. 794 LEGISLATIVE REFERENDUM NO. 371,AGAINST THE PROPOSAL - NO,550199,0,0,270,270
OKLAHOMA,STATE QUESTION NO. 794 LEGISLATIVE REFERENDUM NO. 371,FOR THE PROPOSAL - YES,550200,0,0,789,789
OKLAHOMA,STATE QUESTION NO. 794 LEGISLATIVE REFERENDUM NO. 371,AGAINST THE PROPOSAL - NO,550200,0,0,505,505
OKLAHOMA,STATE QUESTION NO. 794 LEGISLATIVE REFERENDUM NO. 371,FOR THE PROPOSAL - YES,550201,0,0,483,483
OKLAHOMA,STATE QUESTION NO. 794 LEGISLATIVE REFERENDUM NO. 371,AGAINST THE PROPOSAL - NO,550201,0,0,212,212
OKLAHOMA,STATE QUESTION NO. 794 LEGISLATIVE REFERENDUM NO. 371,FOR THE PROPOSAL - YES,550202,0,0,354,354
OKLAHOMA,STATE QUESTION NO. 794 LEGISLATIVE REFERENDUM NO. 371,AGAINST THE PROPOSAL - NO,550202,0,0,228,228
OKLAHOMA,STATE QUESTION NO. 794 LEGISLATIVE REFERENDUM NO. 371,FOR THE PROPOSAL - YES,550203,0,0,435,435
OKLAHOMA,STATE QUESTION NO. 794 LEGISLATIVE REFERENDUM NO. 371,AGAINST THE PROPOSAL - NO,550203,0,0,228,228
OKLAHOMA,STATE QUESTION NO. 794 LEGISLATIVE REFERENDUM NO. 371,FOR THE PROPOSAL - YES,550204,0,0,867,867
OKLAHOMA,STATE QUESTION NO. 794 LEGISLATIVE REFERENDUM NO. 371,AGAINST THE PROPOSAL - NO,550204,0,0,606,606
OKLAHOMA,STATE QUESTION NO. 794 LEGISLATIVE REFERENDUM NO. 371,FOR THE PROPOSAL - YES,550205,0,0,416,416
OKLAHOMA,STATE QUESTION NO. 794 LEGISLATIVE REFERENDUM NO. 371,AGAINST THE PROPOSAL - NO,550205,0,0,227,227
OKLAHOMA,STATE QUESTION NO. 794 LEGISLATIVE REFERENDUM NO. 371,FOR THE PROPOSAL - YES,550206,0,0,155,155
OKLAHOMA,STATE QUESTION NO. 794 LEGISLATIVE REFERENDUM NO. 371,AGAINST THE PROPOSAL - NO,550206,0,0,34,34
OKLAHOMA,STATE QUESTION NO. 794 LEGISLATIVE REFERENDUM NO. 371,FOR THE PROPOSAL - YES,550207,0,0,476,476
OKLAHOMA,STATE QUESTION NO. 794 LEGISLATIVE REFERENDUM NO. 371,AGAINST THE PROPOSAL - NO,550207,0,0,110,110
OKLAHOMA,STATE QUESTION NO. 794 LEGISLATIVE REFERENDUM NO. 371,FOR THE PROPOSAL - YES,550208,0,0,12,12
OKLAHOMA,STATE QUESTION NO. 794 LEGISLATIVE REFERENDUM NO. 371,AGAINST THE PROPOSAL - NO,550208,0,0,2,2
OKLAHOMA,STATE QUESTION NO. 794 LEGISLATIVE REFERENDUM NO. 371,FOR THE PROPOSAL - YES,550209,0,0,434,434
OKLAHOMA,STATE QUESTION NO. 794 LEGISLATIVE REFERENDUM NO. 371,AGAINST THE PROPOSAL - NO,550209,0,0,109,109
OKLAHOMA,STATE QUESTION NO. 794 LEGISLATIVE REFERENDUM NO. 371,FOR THE PROPOSAL - YES,550210,0,0,364,364
OKLAHOMA,STATE QUESTION NO. 794 LEGISLATIVE REFERENDUM NO. 371,AGAINST THE PROPOSAL - NO,550210,0,0,91,91
OKLAHOMA,STATE QUESTION NO. 794 LEGISLATIVE REFERENDUM NO. 371,FOR THE PROPOSAL - YES,550211,0,0,314,314
OKLAHOMA,STATE QUESTION NO. 794 LEGISLATIVE REFERENDUM NO. 371,AGAINST THE PROPOSAL - NO,550211,0,0,77,77
OKLAHOMA,STATE QUESTION NO. 794 LEGISLATIVE REFERENDUM NO. 371,FOR THE PROPOSAL - YES,550212,0,0,284,284
OKLAHOMA,STATE QUESTION NO. 794 LEGISLATIVE REFERENDUM NO. 371,AGAINST THE PROPOSAL - NO,550212,0,0,61,61
OKLAHOMA,STATE QUESTION NO. 794 LEGISLATIVE REFERENDUM NO. 371,FOR THE PROPOSAL - YES,550213,0,0,169,169
OKLAHOMA,STATE QUESTION NO. 794 LEGISLATIVE REFERENDUM NO. 371,AGAINST THE PROPOSAL - NO,550213,0,0,61,61
OKLAHOMA,STATE QUESTION NO. 794 LEGISLATIVE REFERENDUM NO. 371,FOR THE PROPOSAL - YES,550214,0,0,233,233
OKLAHOMA,STATE QUESTION NO. 794 LEGISLATIVE REFERENDUM NO. 371,AGAINST THE PROPOSAL - NO,550214,0,0,70,70
OKLAHOMA,STATE QUESTION NO. 794 LEGISLATIVE REFERENDUM NO. 371,FOR THE PROPOSAL - YES,550215,0,0,300,300
OKLAHOMA,STATE QUESTION NO. 794 LEGISLATIVE REFERENDUM NO. 371,AGAINST THE PROPOSAL - NO,550215,0,0,110,110
OKLAHOMA,STATE QUESTION NO. 794 LEGISLATIVE REFERENDUM NO. 371,FOR THE PROPOSAL - YES,550216,0,0,19,19
OKLAHOMA,STATE QUESTION NO. 794 LEGISLATIVE REFERENDUM NO. 371,AGAINST THE PROPOSAL - NO,550216,0,0,2,2
OKLAHOMA,STATE QUESTION NO. 794 LEGISLATIVE REFERENDUM NO. 371,FOR THE PROPOSAL - YES,550217,0,0,420,420
OKLAHOMA,STATE QUESTION NO. 794 LEGISLATIVE REFERENDUM NO. 371,AGAINST THE PROPOSAL - NO,550217,0,0,95,95
OKLAHOMA,STATE QUESTION NO. 794 LEGISLATIVE REFERENDUM NO. 371,FOR THE PROPOSAL - YES,550218,0,0,559,559
OKLAHOMA,STATE QUESTION NO. 794 LEGISLATIVE REFERENDUM NO. 371,AGAINST THE PROPOSAL - NO,550218,0,0,132,132
OKLAHOMA,STATE QUESTION NO. 794 LEGISLATIVE REFERENDUM NO. 371,FOR THE PROPOSAL - YES,550219,0,0,316,316
OKLAHOMA,STATE QUESTION NO. 794 LEGISLATIVE REFERENDUM NO. 371,AGAINST THE PROPOSAL - NO,550219,0,0,88,88
OKLAHOMA,STATE QUESTION NO. 794 LEGISLATIVE REFERENDUM NO. 371,FOR THE PROPOSAL - YES,550220,0,0,569,569
OKLAHOMA,STATE QUESTION NO. 794 LEGISLATIVE REFERENDUM NO. 371,AGAINST THE PROPOSAL - NO,550220,0,0,151,151
OKLAHOMA,STATE QUESTION NO. 794 LEGISLATIVE REFERENDUM NO. 371,FOR THE PROPOSAL - YES,550221,0,0,618,618
OKLAHOMA,STATE QUESTION NO. 794 LEGISLATIVE REFERENDUM NO. 371,AGAINST THE PROPOSAL - NO,550221,0,0,136,136
OKLAHOMA,STATE QUESTION NO. 794 LEGISLATIVE REFERENDUM NO. 371,FOR THE PROPOSAL - YES,550222,0,0,355,355
OKLAHOMA,STATE QUESTION NO. 794 LEGISLATIVE REFERENDUM NO. 371,AGAINST THE PROPOSAL - NO,550222,0,0,98,98
OKLAHOMA,STATE QUESTION NO. 794 LEGISLATIVE REFERENDUM NO. 371,FOR THE PROPOSAL - YES,550223,0,0,269,269
OKLAHOMA,STATE QUESTION NO. 794 LEGISLATIVE REFERENDUM NO. 371,AGAINST THE PROPOSAL - NO,550223,0,0,71,71
OKLAHOMA,STATE QUESTION NO. 794 LEGISLATIVE REFERENDUM NO. 371,FOR THE PROPOSAL - YES,550224,0,0,380,380
OKLAHOMA,STATE QUESTION NO. 794 LEGISLATIVE REFERENDUM NO. 371,AGAINST THE PROPOSAL - NO,550224,0,0,92,92
OKLAHOMA,STATE QUESTION NO. 794 LEGISLATIVE REFERENDUM NO. 371,FOR THE PROPOSAL - YES,550225,0,0,72,72
OKLAHOMA,STATE QUESTION NO. 794 LEGISLATIVE REFERENDUM NO. 371,AGAINST THE PROPOSAL - NO,550225,0,0,14,14
OKLAHOMA,STATE QUESTION NO. 794 LEGISLATIVE REFERENDUM NO. 371,FOR THE PROPOSAL - YES,550226,0,0,405,405
OKLAHOMA,STATE QUESTION NO. 794 LEGISLATIVE REFERENDUM NO. 371,AGAINST THE PROPOSAL - NO,550226,0,0,82,82
OKLAHOMA,STATE QUESTION NO. 794 LEGISLATIVE REFERENDUM NO. 371,FOR THE PROPOSAL - YES,550227,0,0,338,338
OKLAHOMA,STATE QUESTION NO. 794 LEGISLATIVE REFERENDUM NO. 371,AGAINST THE PROPOSAL - NO,550227,0,0,72,72
OKLAHOMA,STATE QUESTION NO. 794 LEGISLATIVE REFERENDUM NO. 371,FOR THE PROPOSAL - YES,550228,0,0,372,372
OKLAHOMA,STATE QUESTION NO. 794 LEGISLATIVE REFERENDUM NO. 371,AGAINST THE PROPOSAL - NO,550228,0,0,94,94
OKLAHOMA,STATE QUESTION NO. 794 LEGISLATIVE REFERENDUM NO. 371,FOR THE PROPOSAL - YES,550229,0,0,528,528
OKLAHOMA,STATE QUESTION NO. 794 LEGISLATIVE REFERENDUM NO. 371,AGAINST THE PROPOSAL - NO,550229,0,0,116,116
OKLAHOMA,STATE QUESTION NO. 794 LEGISLATIVE REFERENDUM NO. 371,FOR THE PROPOSAL - YES,550230,0,0,572,572
OKLAHOMA,STATE QUESTION NO. 794 LEGISLATIVE REFERENDUM NO. 371,AGAINST THE PROPOSAL - NO,550230,0,0,133,133
OKLAHOMA,STATE QUESTION NO. 794 LEGISLATIVE REFERENDUM NO. 371,FOR THE PROPOSAL - YES,550231,0,0,374,374
OKLAHOMA,STATE QUESTION NO. 794 LEGISLATIVE REFERENDUM NO. 371,AGAINST THE PROPOSAL - NO,550231,0,0,104,104
OKLAHOMA,STATE QUESTION NO. 794 LEGISLATIVE REFERENDUM NO. 371,FOR THE PROPOSAL - YES,550232,0,0,551,551
OKLAHOMA,STATE QUESTION NO. 794 LEGISLATIVE REFERENDUM NO. 371,AGAINST THE PROPOSAL - NO,550232,0,0,147,147
OKLAHOMA,STATE QUESTION NO. 794 LEGISLATIVE REFERENDUM NO. 371,FOR THE PROPOSAL - YES,550233,0,0,167,167
OKLAHOMA,STATE QUESTION NO. 794 LEGISLATIVE REFERENDUM NO. 371,AGAINST THE PROPOSAL - NO,550233,0,0,42,42
OKLAHOMA,STATE QUESTION NO. 794 LEGISLATIVE REFERENDUM NO. 371,FOR THE PROPOSAL - YES,550234,0,0,384,384
OKLAHOMA,STATE QUESTION NO. 794 LEGISLATIVE REFERENDUM NO. 371,AGAINST THE PROPOSAL - NO,550234,0,0,83,83
OKLAHOMA,STATE QUESTION NO. 794 LEGISLATIVE REFERENDUM NO. 371,FOR THE PROPOSAL - YES,550235,0,0,308,308
OKLAHOMA,STATE QUESTION NO. 794 LEGISLATIVE REFERENDUM NO. 371,AGAINST THE PROPOSAL - NO,550235,0,0,92,92
OKLAHOMA,STATE QUESTION NO. 794 LEGISLATIVE REFERENDUM NO. 371,FOR THE PROPOSAL - YES,550236,0,0,0,0
OKLAHOMA,STATE QUESTION NO. 794 LEGISLATIVE REFERENDUM NO. 371,AGAINST THE PROPOSAL - NO,550236,0,0,0,0
OKLAHOMA,STATE QUESTION NO. 794 LEGISLATIVE REFERENDUM NO. 371,FOR THE PROPOSAL - YES,550237,0,0,1,1
OKLAHOMA,STATE QUESTION NO. 794 LEGISLATIVE REFERENDUM NO. 371,AGAINST THE PROPOSAL - NO,550237,0,0,0,0
OKLAHOMA,STATE QUESTION NO. 794 LEGISLATIVE REFERENDUM NO. 371,FOR THE PROPOSAL - YES,550238,0,0,1,1
OKLAHOMA,STATE QUESTION NO. 794 LEGISLATIVE REFERENDUM NO. 371,AGAINST THE PROPOSAL - NO,550238,0,0,0,0
OKLAHOMA,STATE QUESTION NO. 794 LEGISLATIVE REFERENDUM NO. 371,FOR THE PROPOSAL - YES,550239,0,0,652,652
OKLAHOMA,STATE QUESTION NO. 794 LEGISLATIVE REFERENDUM NO. 371,AGAINST THE PROPOSAL - NO,550239,0,0,244,244
OKLAHOMA,STATE QUESTION NO. 794 LEGISLATIVE REFERENDUM NO. 371,FOR THE PROPOSAL - YES,550240,0,0,468,468
OKLAHOMA,STATE QUESTION NO. 794 LEGISLATIVE REFERENDUM NO. 371,AGAINST THE PROPOSAL - NO,550240,0,0,109,109
OKLAHOMA,STATE QUESTION NO. 794 LEGISLATIVE REFERENDUM NO. 371,FOR THE PROPOSAL - YES,550241,0,0,364,364
OKLAHOMA,STATE QUESTION NO. 794 LEGISLATIVE REFERENDUM NO. 371,AGAINST THE PROPOSAL - NO,550241,0,0,174,174
OKLAHOMA,STATE QUESTION NO. 794 LEGISLATIVE REFERENDUM NO. 371,FOR THE PROPOSAL - YES,550242,0,0,307,307
OKLAHOMA,STATE QUESTION NO. 794 LEGISLATIVE REFERENDUM NO. 371,AGAINST THE PROPOSAL - NO,550242,0,0,107,107
OKLAHOMA,STATE QUESTION NO. 794 LEGISLATIVE REFERENDUM NO. 371,FOR THE PROPOSAL - YES,550243,0,0,455,455
OKLAHOMA,STATE QUESTION NO. 794 LEGISLATIVE REFERENDUM NO. 371,AGAINST THE PROPOSAL - NO,550243,0,0,103,103
OKLAHOMA,STATE QUESTION NO. 794 LEGISLATIVE REFERENDUM NO. 371,FOR THE PROPOSAL - YES,550244,0,0,442,442
OKLAHOMA,STATE QUESTION NO. 794 LEGISLATIVE REFERENDUM NO. 371,AGAINST THE PROPOSAL - NO,550244,0,0,103,103
OKLAHOMA,STATE QUESTION NO. 794 LEGISLATIVE REFERENDUM NO. 371,FOR THE PROPOSAL - YES,550245,0,0,518,518
OKLAHOMA,STATE QUESTION NO. 794 LEGISLATIVE REFERENDUM NO. 371,AGAINST THE PROPOSAL - NO,550245,0,0,146,146
OKLAHOMA,STATE QUESTION NO. 794 LEGISLATIVE REFERENDUM NO. 371,FOR THE PROPOSAL - YES,550246,0,0,151,151
OKLAHOMA,STATE QUESTION NO. 794 LEGISLATIVE REFERENDUM NO. 371,AGAINST THE PROPOSAL - NO,550246,0,0,23,23
OKLAHOMA,STATE QUESTION NO. 794 LEGISLATIVE REFERENDUM NO. 371,FOR THE PROPOSAL - YES,550247,0,0,350,350
OKLAHOMA,STATE QUESTION NO. 794 LEGISLATIVE REFERENDUM NO. 371,AGAINST THE PROPOSAL - NO,550247,0,0,76,76
OKLAHOMA,STATE QUESTION NO. 794 LEGISLATIVE REFERENDUM NO. 371,FOR THE PROPOSAL - YES,550248,0,0,777,777
OKLAHOMA,STATE QUESTION NO. 794 LEGISLATIVE REFERENDUM NO. 371,AGAINST THE PROPOSAL - NO,550248,0,0,204,204
OKLAHOMA,STATE QUESTION NO. 794 LEGISLATIVE REFERENDUM NO. 371,FOR THE PROPOSAL - YES,550249,0,0,1057,1057
OKLAHOMA,STATE QUESTION NO. 794 LEGISLATIVE REFERENDUM NO. 371,AGAINST THE PROPOSAL - NO,550249,0,0,212,212
OKLAHOMA,STATE QUESTION NO. 794 LEGISLATIVE REFERENDUM NO. 371,FOR THE PROPOSAL - YES,550250,0,0,764,764
OKLAHOMA,STATE QUESTION NO. 794 LEGISLATIVE REFERENDUM NO. 371,AGAINST THE PROPOSAL - NO,550250,0,0,216,216
OKLAHOMA,STATE QUESTION NO. 794 LEGISLATIVE REFERENDUM NO. 371,FOR THE PROPOSAL - YES,550251,0,0,984,984
OKLAHOMA,STATE QUESTION NO. 794 LEGISLATIVE REFERENDUM NO. 371,AGAINST THE PROPOSAL - NO,550251,0,0,253,253
OKLAHOMA,STATE QUESTION NO. 794 LEGISLATIVE REFERENDUM NO. 371,FOR THE PROPOSAL - YES,550252,0,0,983,983
OKLAHOMA,STATE QUESTION NO. 794 LEGISLATIVE REFERENDUM NO. 371,AGAINST THE PROPOSAL - NO,550252,0,0,223,223
OKLAHOMA,STATE QUESTION NO. 794 LEGISLATIVE REFERENDUM NO. 371,FOR THE PROPOSAL - YES,550253,0,0,308,308
OKLAHOMA,STATE QUESTION NO. 794 LEGISLATIVE REFERENDUM NO. 371,AGAINST THE PROPOSAL - NO,550253,0,0,70,70
OKLAHOMA,STATE QUESTION NO. 794 LEGISLATIVE REFERENDUM NO. 371,FOR THE PROPOSAL - YES,550254,0,0,1013,1013
OKLAHOMA,STATE QUESTION NO. 794 LEGISLATIVE REFERENDUM NO. 371,AGAINST THE PROPOSAL - NO,550254,0,0,253,253
OKLAHOMA,STATE QUESTION NO. 794 LEGISLATIVE REFERENDUM NO. 371,FOR THE PROPOSAL - YES,550255,0,0,0,0
OKLAHOMA,STATE QUESTION NO. 794 LEGISLATIVE REFERENDUM NO. 371,AGAINST THE PROPOSAL - NO,550255,0,0,0,0
OKLAHOMA,STATE QUESTION NO. 794 LEGISLATIVE REFERENDUM NO. 371,FOR THE PROPOSAL - YES,550256,0,0,0,0
OKLAHOMA,STATE QUESTION NO. 794 LEGISLATIVE REFERENDUM NO. 371,AGAINST THE PROPOSAL - NO,550256,0,0,0,0
OKLAHOMA,STATE QUESTION NO. 794 LEGISLATIVE REFERENDUM NO. 371,FOR THE PROPOSAL - YES,550257,0,0,73,73
OKLAHOMA,STATE QUESTION NO. 794 LEGISLATIVE REFERENDUM NO. 371,AGAINST THE PROPOSAL - NO,550257,0,0,29,29
OKLAHOMA,STATE QUESTION NO. 794 LEGISLATIVE REFERENDUM NO. 371,FOR THE PROPOSAL - YES,559999,17784,12145,0,29929
OKLAHOMA,STATE QUESTION NO. 794 LEGISLATIVE REFERENDUM NO. 371,AGAINST THE PROPOSAL - NO,559999,4258,3384,1,7643
OKMULGEE,STATE QUESTION NO. 794 LEGISLATIVE REFERENDUM NO. 371,FOR THE PROPOSAL - YES,560004,1,3,61,65
OKMULGEE,STATE QUESTION NO. 794 LEGISLATIVE REFERENDUM NO. 371,AGAINST THE PROPOSAL - NO,560004,1,1,13,15
OKMULGEE,STATE QUESTION NO. 794 LEGISLATIVE REFERENDUM NO. 371,FOR THE PROPOSAL - YES,560007,8,42,204,254
OKMULGEE,STATE QUESTION NO. 794 LEGISLATIVE REFERENDUM NO. 371,AGAINST THE PROPOSAL - NO,560007,2,15,52,69
OKMULGEE,STATE QUESTION NO. 794 LEGISLATIVE REFERENDUM NO. 371,FOR THE PROPOSAL - YES,560008,18,81,440,539
OKMULGEE,STATE QUESTION NO. 794 LEGISLATIVE REFERENDUM NO. 371,AGAINST THE PROPOSAL - NO,560008,1,20,119,140
OKMULGEE,STATE QUESTION NO. 794 LEGISLATIVE REFERENDUM NO. 371,FOR THE PROPOSAL - YES,560009,29,126,406,561
OKMULGEE,STATE QUESTION NO. 794 LEGISLATIVE REFERENDUM NO. 371,AGAINST THE PROPOSAL - NO,560009,2,33,106,141
OKMULGEE,STATE QUESTION NO. 794 LEGISLATIVE REFERENDUM NO. 371,FOR THE PROPOSAL - YES,560010,3,17,129,149
OKMULGEE,STATE QUESTION NO. 794 LEGISLATIVE REFERENDUM NO. 371,AGAINST THE PROPOSAL - NO,560010,0,3,38,41
OKMULGEE,STATE QUESTION NO. 794 LEGISLATIVE REFERENDUM NO. 371,FOR THE PROPOSAL - YES,560011,26,140,665,831
OKMULGEE,STATE QUESTION NO. 794 LEGISLATIVE REFERENDUM NO. 371,AGAINST THE PROPOSAL - NO,560011,8,44,175,227
OKMULGEE,STATE QUESTION NO. 794 LEGISLATIVE REFERENDUM NO. 371,FOR THE PROPOSAL - YES,560013,3,4,232,239
OKMULGEE,STATE QUESTION NO. 794 LEGISLATIVE REFERENDUM NO. 371,AGAINST THE PROPOSAL - NO,560013,0,2,43,45
OKMULGEE,STATE QUESTION NO. 794 LEGISLATIVE REFERENDUM NO. 371,FOR THE PROPOSAL - YES,560014,6,4,169,179
OKMULGEE,STATE QUESTION NO. 794 LEGISLATIVE REFERENDUM NO. 371,AGAINST THE PROPOSAL - NO,560014,2,0,26,28
OKMULGEE,STATE QUESTION NO. 794 LEGISLATIVE REFERENDUM NO. 371,FOR THE PROPOSAL - YES,560015,15,21,436,472
OKMULGEE,STATE QUESTION NO. 794 LEGISLATIVE REFERENDUM NO. 371,AGAINST THE PROPOSAL - NO,560015,8,5,114,127
OKMULGEE,STATE QUESTION NO. 794 LEGISLATIVE REFERENDUM NO. 371,FOR THE PROPOSAL - YES,560016,13,23,262,298
OKMULGEE,STATE QUESTION NO. 794 LEGISLATIVE REFERENDUM NO. 371,AGAINST THE PROPOSAL - NO,560016,1,12,72,85
OKMULGEE,STATE QUESTION NO. 794 LEGISLATIVE REFERENDUM NO. 371,FOR THE PROPOSAL - YES,560018,11,8,227,246
OKMULGEE,STATE QUESTION NO. 794 LEGISLATIVE REFERENDUM NO. 371,AGAINST THE PROPOSAL - NO,560018,3,4,62,69
OKMULGEE,STATE QUESTION NO. 794 LEGISLATIVE REFERENDUM NO. 371,FOR THE PROPOSAL - YES,560019,5,7,211,223
OKMULGEE,STATE QUESTION NO. 794 LEGISLATIVE REFERENDUM NO. 371,AGAINST THE PROPOSAL - NO,560019,2,6,53,61
OKMULGEE,STATE QUESTION NO. 794 LEGISLATIVE REFERENDUM NO. 371,FOR THE PROPOSAL - YES,560020,30,39,802,871
OKMULGEE,STATE QUESTION NO. 794 LEGISLATIVE REFERENDUM NO. 371,AGAINST THE PROPOSAL - NO,560020,6,11,215,232
OKMULGEE,STATE QUESTION NO. 794 LEGISLATIVE REFERENDUM NO. 371,FOR THE PROPOSAL - YES,560021,0,12,167,179
OKMULGEE,STATE QUESTION NO. 794 LEGISLATIVE REFERENDUM NO. 371,AGAINST THE PROPOSAL - NO,560021,2,4,58,64
OKMULGEE,STATE QUESTION NO. 794 LEGISLATIVE REFERENDUM NO. 371,FOR THE PROPOSAL - YES,560026,4,36,444,484
OKMULGEE,STATE QUESTION NO. 794 LEGISLATIVE REFERENDUM NO. 371,AGAINST THE PROPOSAL - NO,560026,1,14,142,157
OKMULGEE,STATE QUESTION NO. 794 LEGISLATIVE REFERENDUM NO. 371,FOR THE PROPOSAL - YES,560027,32,18,287,337
OKMULGEE,STATE QUESTION NO. 794 LEGISLATIVE REFERENDUM NO. 371,AGAINST THE PROPOSAL - NO,560027,7,3,80,90
OKMULGEE,STATE QUESTION NO. 794 LEGISLATIVE REFERENDUM NO. 371,FOR THE PROPOSAL - YES,560029,49,48,772,869
OKMULGEE,STATE QUESTION NO. 794 LEGISLATIVE REFERENDUM NO. 371,AGAINST THE PROPOSAL - NO,560029,11,14,189,214
OKMULGEE,STATE QUESTION NO. 794 LEGISLATIVE REFERENDUM NO. 371,FOR THE PROPOSAL - YES,560031,3,6,144,153
OKMULGEE,STATE QUESTION NO. 794 LEGISLATIVE REFERENDUM NO. 371,AGAINST THE PROPOSAL - NO,560031,0,4,38,42
OKMULGEE,STATE QUESTION NO. 794 LEGISLATIVE REFERENDUM NO. 371,FOR THE PROPOSAL - YES,560032,9,28,207,244
OKMULGEE,STATE QUESTION NO. 794 LEGISLATIVE REFERENDUM NO. 371,AGAINST THE PROPOSAL - NO,560032,1,5,65,71
OKMULGEE,STATE QUESTION NO. 794 LEGISLATIVE REFERENDUM NO. 371,FOR THE PROPOSAL - YES,560033,12,18,231,261
OKMULGEE,STATE QUESTION NO. 794 LEGISLATIVE REFERENDUM NO. 371,AGAINST THE PROPOSAL - NO,560033,0,6,70,76
OKMULGEE,STATE QUESTION NO. 794 LEGISLATIVE REFERENDUM NO. 371,FOR THE PROPOSAL - YES,560034,5,13,206,224
OKMULGEE,STATE QUESTION NO. 794 LEGISLATIVE REFERENDUM NO. 371,AGAINST THE PROPOSAL - NO,560034,0,3,47,50
OKMULGEE,STATE QUESTION NO. 794 LEGISLATIVE REFERENDUM NO. 371,FOR THE PROPOSAL - YES,560035,5,1,214,220
OKMULGEE,STATE QUESTION NO. 794 LEGISLATIVE REFERENDUM NO. 371,AGAINST THE PROPOSAL - NO,560035,1,5,41,47
OKMULGEE,STATE QUESTION NO. 794 LEGISLATIVE REFERENDUM NO. 371,FOR THE PROPOSAL - YES,560036,12,38,396,446
OKMULGEE,STATE QUESTION NO. 794 LEGISLATIVE REFERENDUM NO. 371,AGAINST THE PROPOSAL - NO,560036,7,21,119,147
OKMULGEE,STATE QUESTION NO. 794 LEGISLATIVE REFERENDUM NO. 371,FOR THE PROPOSAL - YES,560038,4,10,182,196
OKMULGEE,STATE QUESTION NO. 794 LEGISLATIVE REFERENDUM NO. 371,AGAINST THE PROPOSAL - NO,560038,3,4,33,40
OSAGE,STATE QUESTION NO. 794 LEGISLATIVE REFERENDUM NO. 371,FOR THE PROPOSAL - YES,570101,4,3,108,115
OSAGE,STATE QUESTION NO. 794 LEGISLATIVE REFERENDUM NO. 371,AGAINST THE PROPOSAL - NO,570101,0,2,16,18
OSAGE,STATE QUESTION NO. 794 LEGISLATIVE REFERENDUM NO. 371,FOR THE PROPOSAL - YES,570102,5,8,99,112
OSAGE,STATE QUESTION NO. 794 LEGISLATIVE REFERENDUM NO. 371,AGAINST THE PROPOSAL - NO,570102,3,0,27,30
OSAGE,STATE QUESTION NO. 794 LEGISLATIVE REFERENDUM NO. 371,FOR THE PROPOSAL - YES,570103,4,2,155,161
OSAGE,STATE QUESTION NO. 794 LEGISLATIVE REFERENDUM NO. 371,AGAINST THE PROPOSAL - NO,570103,2,0,44,46
OSAGE,STATE QUESTION NO. 794 LEGISLATIVE REFERENDUM NO. 371,FOR THE PROPOSAL - YES,570105,31,3,526,560
OSAGE,STATE QUESTION NO. 794 LEGISLATIVE REFERENDUM NO. 371,AGAINST THE PROPOSAL - NO,570105,5,0,108,113
OSAGE,STATE QUESTION NO. 794 LEGISLATIVE REFERENDUM NO. 371,FOR THE PROPOSAL - YES,570106,0,0,41,41
OSAGE,STATE QUESTION NO. 794 LEGISLATIVE REFERENDUM NO. 371,AGAINST THE PROPOSAL - NO,570106,1,0,12,13
OSAGE,STATE QUESTION NO. 794 LEGISLATIVE REFERENDUM NO. 371,FOR THE PROPOSAL - YES,570107,32,126,516,674
OSAGE,STATE QUESTION NO. 794 LEGISLATIVE REFERENDUM NO. 371,AGAINST THE PROPOSAL - NO,570107,13,37,134,184
OSAGE,STATE QUESTION NO. 794 LEGISLATIVE REFERENDUM NO. 371,FOR THE PROPOSAL - YES,570108,15,68,348,431
OSAGE,STATE QUESTION NO. 794 LEGISLATIVE REFERENDUM NO. 371,AGAINST THE PROPOSAL - NO,570108,3,14,75,92
OSAGE,STATE QUESTION NO. 794 LEGISLATIVE REFERENDUM NO. 371,FOR THE PROPOSAL - YES,570109,26,24,496,546
OSAGE,STATE QUESTION NO. 794 LEGISLATIVE REFERENDUM NO. 371,AGAINST THE PROPOSAL - NO,570109,6,5,111,122
OSAGE,STATE QUESTION NO. 794 LEGISLATIVE REFERENDUM NO. 371,FOR THE PROPOSAL - YES,570110,18,13,388,419
OSAGE,STATE QUESTION NO. 794 LEGISLATIVE REFERENDUM NO. 371,AGAINST THE PROPOSAL - NO,570110,7,6,118,131
OSAGE,STATE QUESTION NO. 794 LEGISLATIVE REFERENDUM NO. 371,FOR THE PROPOSAL - YES,570111,5,11,144,160
OSAGE,STATE QUESTION NO. 794 LEGISLATIVE REFERENDUM NO. 371,AGAINST THE PROPOSAL - NO,570111,1,2,30,33
OSAGE,STATE QUESTION NO. 794 LEGISLATIVE REFERENDUM NO. 371,FOR THE PROPOSAL - YES,570112,20,17,264,301
OSAGE,STATE QUESTION NO. 794 LEGISLATIVE REFERENDUM NO. 371,AGAINST THE PROPOSAL - NO,570112,7,5,60,72
OSAGE,STATE QUESTION NO. 794 LEGISLATIVE REFERENDUM NO. 371,FOR THE PROPOSAL - YES,570113,1,2,29,32
OSAGE,STATE QUESTION NO. 794 LEGISLATIVE REFERENDUM NO. 371,AGAINST THE PROPOSAL - NO,570113,1,1,8,10
OSAGE,STATE QUESTION NO. 794 LEGISLATIVE REFERENDUM NO. 371,FOR THE PROPOSAL - YES,570201,50,128,1074,1252
OSAGE,STATE QUESTION NO. 794 LEGISLATIVE REFERENDUM NO. 371,AGAINST THE PROPOSAL - NO,570201,9,33,268,310
OSAGE,STATE QUESTION NO. 794 LEGISLATIVE REFERENDUM NO. 371,FOR THE PROPOSAL - YES,570202,99,64,905,1068
OSAGE,STATE QUESTION NO. 794 LEGISLATIVE REFERENDUM NO. 371,AGAINST THE PROPOSAL - NO,570202,34,28,222,284
OSAGE,STATE QUESTION NO. 794 LEGISLATIVE REFERENDUM NO. 371,FOR THE PROPOSAL - YES,570203,102,282,1236,1620
OSAGE,STATE QUESTION NO. 794 LEGISLATIVE REFERENDUM NO. 371,AGAINST THE PROPOSAL - NO,570203,21,48,374,443
OSAGE,STATE QUESTION NO. 794 LEGISLATIVE REFERENDUM NO. 371,FOR THE PROPOSAL - YES,570204,30,25,396,451
OSAGE,STATE QUESTION NO. 794 LEGISLATIVE REFERENDUM NO. 371,AGAINST THE PROPOSAL - NO,570204,5,9,101,115
OSAGE,STATE QUESTION NO. 794 LEGISLATIVE REFERENDUM NO. 371,FOR THE PROPOSAL - YES,570205,8,0,120,128
OSAGE,STATE QUESTION NO. 794 LEGISLATIVE REFERENDUM NO. 371,AGAINST THE PROPOSAL - NO,570205,4,2,45,51
OSAGE,STATE QUESTION NO. 794 LEGISLATIVE REFERENDUM NO. 371,FOR THE PROPOSAL - YES,570301,19,5,350,374
OSAGE,STATE QUESTION NO. 794 LEGISLATIVE REFERENDUM NO. 371,AGAINST THE PROPOSAL - NO,570301,7,1,83,91
OSAGE,STATE QUESTION NO. 794 LEGISLATIVE REFERENDUM NO. 371,FOR THE PROPOSAL - YES,570302,3,0,73,76
OSAGE,STATE QUESTION NO. 794 LEGISLATIVE REFERENDUM NO. 371,AGAINST THE PROPOSAL - NO,570302,4,1,20,25
OSAGE,STATE QUESTION NO. 794 LEGISLATIVE REFERENDUM NO. 371,FOR THE PROPOSAL - YES,570303,11,7,246,264
OSAGE,STATE QUESTION NO. 794 LEGISLATIVE REFERENDUM NO. 371,AGAINST THE PROPOSAL - NO,570303,6,0,44,50
OSAGE,STATE QUESTION NO. 794 LEGISLATIVE REFERENDUM NO. 371,FOR THE PROPOSAL - YES,570305,23,9,217,249
OSAGE,STATE QUESTION NO. 794 LEGISLATIVE REFERENDUM NO. 371,AGAINST THE PROPOSAL - NO,570305,7,1,93,101
OSAGE,STATE QUESTION NO. 794 LEGISLATIVE REFERENDUM NO. 371,FOR THE PROPOSAL - YES,570306,8,10,309,327
OSAGE,STATE QUESTION NO. 794 LEGISLATIVE REFERENDUM NO. 371,AGAINST THE PROPOSAL - NO,570306,2,3,69,74
OSAGE,STATE QUESTION NO. 794 LEGISLATIVE REFERENDUM NO. 371,FOR THE PROPOSAL - YES,570307,11,13,341,365
OSAGE,STATE QUESTION NO. 794 LEGISLATIVE REFERENDUM NO. 371,AGAINST THE PROPOSAL - NO,570307,1,6,119,126
OSAGE,STATE QUESTION NO. 794 LEGISLATIVE REFERENDUM NO. 371,FOR THE PROPOSAL - YES,570308,34,24,693,751
OSAGE,STATE QUESTION NO. 794 LEGISLATIVE REFERENDUM NO. 371,AGAINST THE PROPOSAL - NO,570308,22,6,168,196
OSAGE,STATE QUESTION NO. 794 LEGISLATIVE REFERENDUM NO. 371,FOR THE PROPOSAL - YES,570309,17,5,370,392
OSAGE,STATE QUESTION NO. 794 LEGISLATIVE REFERENDUM NO. 371,AGAINST THE PROPOSAL - NO,570309,5,4,74,83
OSAGE,STATE QUESTION NO. 794 LEGISLATIVE REFERENDUM NO. 371,FOR THE PROPOSAL - YES,570310,38,24,550,612
OSAGE,STATE QUESTION NO. 794 LEGISLATIVE REFERENDUM NO. 371,AGAINST THE PROPOSAL - NO,570310,11,3,174,188
OSAGE,STATE QUESTION NO. 794 LEGISLATIVE REFERENDUM NO. 371,FOR THE PROPOSAL - YES,570311,20,3,50,73
OSAGE,STATE QUESTION NO. 794 LEGISLATIVE REFERENDUM NO. 371,AGAINST THE PROPOSAL - NO,570311,1,0,21,22
OSAGE,STATE QUESTION NO. 794 LEGISLATIVE REFERENDUM NO. 371,FOR THE PROPOSAL - YES,570312,33,5,373,411
OSAGE,STATE QUESTION NO. 794 LEGISLATIVE REFERENDUM NO. 371,AGAINST THE PROPOSAL - NO,570312,13,8,89,110
OTTAWA,STATE QUESTION NO. 794 LEGISLATIVE REFERENDUM NO. 371,FOR THE PROPOSAL - YES,580002,11,41,270,322
OTTAWA,STATE QUESTION NO. 794 LEGISLATIVE REFERENDUM NO. 371,AGAINST THE PROPOSAL - NO,580002,4,20,99,123
OTTAWA,STATE QUESTION NO. 794 LEGISLATIVE REFERENDUM NO. 371,FOR THE PROPOSAL - YES,580003,12,52,352,416
OTTAWA,STATE QUESTION NO. 794 LEGISLATIVE REFERENDUM NO. 371,AGAINST THE PROPOSAL - NO,580003,4,24,144,172
OTTAWA,STATE QUESTION NO. 794 LEGISLATIVE REFERENDUM NO. 371,FOR THE PROPOSAL - YES,580004,15,35,168,218
OTTAWA,STATE QUESTION NO. 794 LEGISLATIVE REFERENDUM NO. 371,AGAINST THE PROPOSAL - NO,580004,9,9,80,98
OTTAWA,STATE QUESTION NO. 794 LEGISLATIVE REFERENDUM NO. 371,FOR THE PROPOSAL - YES,580005,4,25,192,221
OTTAWA,STATE QUESTION NO. 794 LEGISLATIVE REFERENDUM NO. 371,AGAINST THE PROPOSAL - NO,580005,2,8,55,65
OTTAWA,STATE QUESTION NO. 794 LEGISLATIVE REFERENDUM NO. 371,FOR THE PROPOSAL - YES,580007,16,78,520,614
OTTAWA,STATE QUESTION NO. 794 LEGISLATIVE REFERENDUM NO. 371,AGAINST THE PROPOSAL - NO,580007,3,17,194,214
OTTAWA,STATE QUESTION NO. 794 LEGISLATIVE REFERENDUM NO. 371,FOR THE PROPOSAL - YES,580008,5,16,101,122
OTTAWA,STATE QUESTION NO. 794 LEGISLATIVE REFERENDUM NO. 371,AGAINST THE PROPOSAL - NO,580008,0,5,56,61
OTTAWA,STATE QUESTION NO. 794 LEGISLATIVE REFERENDUM NO. 371,FOR THE PROPOSAL - YES,580009,10,18,188,216
OTTAWA,STATE QUESTION NO. 794 LEGISLATIVE REFERENDUM NO. 371,AGAINST THE PROPOSAL - NO,580009,2,7,76,85
OTTAWA,STATE QUESTION NO. 794 LEGISLATIVE REFERENDUM NO. 371,FOR THE PROPOSAL - YES,580011,13,37,254,304
OTTAWA,STATE QUESTION NO. 794 LEGISLATIVE REFERENDUM NO. 371,AGAINST THE PROPOSAL - NO,580011,1,13,95,109
OTTAWA,STATE QUESTION NO. 794 LEGISLATIVE REFERENDUM NO. 371,FOR THE PROPOSAL - YES,580012,10,24,218,252
OTTAWA,STATE QUESTION NO. 794 LEGISLATIVE REFERENDUM NO. 371,AGAINST THE PROPOSAL - NO,580012,3,9,82,94
OTTAWA,STATE QUESTION NO. 794 LEGISLATIVE REFERENDUM NO. 371,FOR THE PROPOSAL - YES,580014,5,28,421,454
OTTAWA,STATE QUESTION NO. 794 LEGISLATIVE REFERENDUM NO. 371,AGAINST THE PROPOSAL - NO,580014,0,9,214,223
OTTAWA,STATE QUESTION NO. 794 LEGISLATIVE REFERENDUM NO. 371,FOR THE PROPOSAL - YES,580023,11,22,445,478
OTTAWA,STATE QUESTION NO. 794 LEGISLATIVE REFERENDUM NO. 371,AGAINST THE PROPOSAL - NO,580023,6,8,189,203
OTTAWA,STATE QUESTION NO. 794 LEGISLATIVE REFERENDUM NO. 371,FOR THE PROPOSAL - YES,580025,8,14,309,331
OTTAWA,STATE QUESTION NO. 794 LEGISLATIVE REFERENDUM NO. 371,AGAINST THE PROPOSAL - NO,580025,1,4,131,136
OTTAWA,STATE QUESTION NO. 794 LEGISLATIVE REFERENDUM NO. 371,FOR THE PROPOSAL - YES,580026,17,17,453,487
OTTAWA,STATE QUESTION NO. 794 LEGISLATIVE REFERENDUM NO. 371,AGAINST THE PROPOSAL - NO,580026,10,5,179,194
OTTAWA,STATE QUESTION NO. 794 LEGISLATIVE REFERENDUM NO. 371,FOR THE PROPOSAL - YES,580028,17,34,607,658
OTTAWA,STATE QUESTION NO. 794 LEGISLATIVE REFERENDUM NO. 371,AGAINST THE PROPOSAL - NO,580028,5,15,214,234
OTTAWA,STATE QUESTION NO. 794 LEGISLATIVE REFERENDUM NO. 371,FOR THE PROPOSAL - YES,580031,15,52,464,531
OTTAWA,STATE QUESTION NO. 794 LEGISLATIVE REFERENDUM NO. 371,AGAINST THE PROPOSAL - NO,580031,6,23,189,218
OTTAWA,STATE QUESTION NO. 794 LEGISLATIVE REFERENDUM NO. 371,FOR THE PROPOSAL - YES,580034,11,20,293,324
OTTAWA,STATE QUESTION NO. 794 LEGISLATIVE REFERENDUM NO. 371,AGAINST THE PROPOSAL - NO,580034,1,10,97,108
PAWNEE,STATE QUESTION NO. 794 LEGISLATIVE REFERENDUM NO. 371,FOR THE PROPOSAL - YES,590104,9,66,356,431
PAWNEE,STATE QUESTION NO. 794 LEGISLATIVE REFERENDUM NO. 371,AGAINST THE PROPOSAL - NO,590104,1,21,70,92
PAWNEE,STATE QUESTION NO. 794 LEGISLATIVE REFERENDUM NO. 371,FOR THE PROPOSAL - YES,590111,1,10,187,198
PAWNEE,STATE QUESTION NO. 794 LEGISLATIVE REFERENDUM NO. 371,AGAINST THE PROPOSAL - NO,590111,0,2,45,47
PAWNEE,STATE QUESTION NO. 794 LEGISLATIVE REFERENDUM NO. 371,FOR THE PROPOSAL - YES,590112,4,4,117,125
PAWNEE,STATE QUESTION NO. 794 LEGISLATIVE REFERENDUM NO. 371,AGAINST THE PROPOSAL - NO,590112,1,0,43,44
PAWNEE,STATE QUESTION NO. 794 LEGISLATIVE REFERENDUM NO. 371,FOR THE PROPOSAL - YES,590118,17,18,489,524
PAWNEE,STATE QUESTION NO. 794 LEGISLATIVE REFERENDUM NO. 371,AGAINST THE PROPOSAL - NO,590118,6,4,99,109
PAWNEE,STATE QUESTION NO. 794 LEGISLATIVE REFERENDUM NO. 371,FOR THE PROPOSAL - YES,590202,25,136,631,792
PAWNEE,STATE QUESTION NO. 794 LEGISLATIVE REFERENDUM NO. 371,AGAINST THE PROPOSAL - NO,590202,7,28,150,185
PAWNEE,STATE QUESTION NO. 794 LEGISLATIVE REFERENDUM NO. 371,FOR THE PROPOSAL - YES,590215,0,8,83,91
PAWNEE,STATE QUESTION NO. 794 LEGISLATIVE REFERENDUM NO. 371,AGAINST THE PROPOSAL - NO,590215,0,0,17,17
PAWNEE,STATE QUESTION NO. 794 LEGISLATIVE REFERENDUM NO. 371,FOR THE PROPOSAL - YES,590217,22,12,400,434
PAWNEE,STATE QUESTION NO. 794 LEGISLATIVE REFERENDUM NO. 371,AGAINST THE PROPOSAL - NO,590217,1,6,124,131
PAWNEE,STATE QUESTION NO. 794 LEGISLATIVE REFERENDUM NO. 371,FOR THE PROPOSAL - YES,590307,37,35,610,682
PAWNEE,STATE QUESTION NO. 794 LEGISLATIVE REFERENDUM NO. 371,AGAINST THE PROPOSAL - NO,590307,5,2,160,167
PAWNEE,STATE QUESTION NO. 794 LEGISLATIVE REFERENDUM NO. 371,FOR THE PROPOSAL - YES,590309,7,2,153,162
PAWNEE,STATE QUESTION NO. 794 LEGISLATIVE REFERENDUM NO. 371,AGAINST THE PROPOSAL - NO,590309,2,0,46,48
PAWNEE,STATE QUESTION NO. 794 LEGISLATIVE REFERENDUM NO. 371,FOR THE PROPOSAL - YES,590314,12,11,434,457
PAWNEE,STATE QUESTION NO. 794 LEGISLATIVE REFERENDUM NO. 371,AGAINST THE PROPOSAL - NO,590314,0,2,102,104
PAYNE,STATE QUESTION NO. 794 LEGISLATIVE REFERENDUM NO. 371,FOR THE PROPOSAL - YES,600001,12,9,193,214
PAYNE,STATE QUESTION NO. 794 LEGISLATIVE REFERENDUM NO. 371,AGAINST THE PROPOSAL - NO,600001,4,9,62,75
PAYNE,STATE QUESTION NO. 794 LEGISLATIVE REFERENDUM NO. 371,FOR THE PROPOSAL - YES,600002,22,58,473,553
PAYNE,STATE QUESTION NO. 794 LEGISLATIVE REFERENDUM NO. 371,AGAINST THE PROPOSAL - NO,600002,8,19,153,180
PAYNE,STATE QUESTION NO. 794 LEGISLATIVE REFERENDUM NO. 371,FOR THE PROPOSAL - YES,600003,8,39,249,296
PAYNE,STATE QUESTION NO. 794 LEGISLATIVE REFERENDUM NO. 371,AGAINST THE PROPOSAL - NO,600003,0,7,78,85
PAYNE,STATE QUESTION NO. 794 LEGISLATIVE REFERENDUM NO. 371,FOR THE PROPOSAL - YES,600004,33,140,574,747
PAYNE,STATE QUESTION NO. 794 LEGISLATIVE REFERENDUM NO. 371,AGAINST THE PROPOSAL - NO,600004,8,53,210,271
PAYNE,STATE QUESTION NO. 794 LEGISLATIVE REFERENDUM NO. 371,FOR THE PROPOSAL - YES,600005,7,18,169,194
PAYNE,STATE QUESTION NO. 794 LEGISLATIVE REFERENDUM NO. 371,AGAINST THE PROPOSAL - NO,600005,3,7,47,57
PAYNE,STATE QUESTION NO. 794 LEGISLATIVE REFERENDUM NO. 371,FOR THE PROPOSAL - YES,600006,35,121,725,881
PAYNE,STATE QUESTION NO. 794 LEGISLATIVE REFERENDUM NO. 371,AGAINST THE PROPOSAL - NO,600006,10,40,226,276
PAYNE,STATE QUESTION NO. 794 LEGISLATIVE REFERENDUM NO. 371,FOR THE PROPOSAL - YES,600007,12,23,221,256
PAYNE,STATE QUESTION NO. 794 LEGISLATIVE REFERENDUM NO. 371,AGAINST THE PROPOSAL - NO,600007,6,12,96,114
PAYNE,STATE QUESTION NO. 794 LEGISLATIVE REFERENDUM NO. 371,FOR THE PROPOSAL - YES,600008,28,57,347,432
PAYNE,STATE QUESTION NO. 794 LEGISLATIVE REFERENDUM NO. 371,AGAINST THE PROPOSAL - NO,600008,6,24,142,172
PAYNE,STATE QUESTION NO. 794 LEGISLATIVE REFERENDUM NO. 371,FOR THE PROPOSAL - YES,600009,39,153,749,941
PAYNE,STATE QUESTION NO. 794 LEGISLATIVE REFERENDUM NO. 371,AGAINST THE PROPOSAL - NO,600009,14,58,221,293
PAYNE,STATE QUESTION NO. 794 LEGISLATIVE REFERENDUM NO. 371,FOR THE PROPOSAL - YES,600010,21,21,273,315
PAYNE,STATE QUESTION NO. 794 LEGISLATIVE REFERENDUM NO. 371,AGAINST THE PROPOSAL - NO,600010,7,17,94,118
PAYNE,STATE QUESTION NO. 794 LEGISLATIVE REFERENDUM NO. 371,FOR THE PROPOSAL - YES,600011,7,24,123,154
PAYNE,STATE QUESTION NO. 794 LEGISLATIVE REFERENDUM NO. 371,AGAINST THE PROPOSAL - NO,600011,3,10,57,70
PAYNE,STATE QUESTION NO. 794 LEGISLATIVE REFERENDUM NO. 371,FOR THE PROPOSAL - YES,600012,5,22,164,191
PAYNE,STATE QUESTION NO. 794 LEGISLATIVE REFERENDUM NO. 371,AGAINST THE PROPOSAL - NO,600012,3,6,65,74
PAYNE,STATE QUESTION NO. 794 LEGISLATIVE REFERENDUM NO. 371,FOR THE PROPOSAL - YES,600013,44,121,755,920
PAYNE,STATE QUESTION NO. 794 LEGISLATIVE REFERENDUM NO. 371,AGAINST THE PROPOSAL - NO,600013,10,38,225,273
PAYNE,STATE QUESTION NO. 794 LEGISLATIVE REFERENDUM NO. 371,FOR THE PROPOSAL - YES,600014,0,2,25,27
PAYNE,STATE QUESTION NO. 794 LEGISLATIVE REFERENDUM NO. 371,AGAINST THE PROPOSAL - NO,600014,0,1,6,7
PAYNE,STATE QUESTION NO. 794 LEGISLATIVE REFERENDUM NO. 371,FOR THE PROPOSAL - YES,600015,26,62,370,458
PAYNE,STATE QUESTION NO. 794 LEGISLATIVE REFERENDUM NO. 371,AGAINST THE PROPOSAL - NO,600015,10,51,127,188
PAYNE,STATE QUESTION NO. 794 LEGISLATIVE REFERENDUM NO. 371,FOR THE PROPOSAL - YES,600016,68,372,1019,1459
PAYNE,STATE QUESTION NO. 794 LEGISLATIVE REFERENDUM NO. 371,AGAINST THE PROPOSAL - NO,600016,29,133,363,525
PAYNE,STATE QUESTION NO. 794 LEGISLATIVE REFERENDUM NO. 371,FOR THE PROPOSAL - YES,600101,22,18,496,536
PAYNE,STATE QUESTION NO. 794 LEGISLATIVE REFERENDUM NO. 371,AGAINST THE PROPOSAL - NO,600101,4,17,110,131
PAYNE,STATE QUESTION NO. 794 LEGISLATIVE REFERENDUM NO. 371,FOR THE PROPOSAL - YES,600102,24,16,556,596
PAYNE,STATE QUESTION NO. 794 LEGISLATIVE REFERENDUM NO. 371,AGAINST THE PROPOSAL - NO,600102,7,4,105,116
PAYNE,STATE QUESTION NO. 794 LEGISLATIVE REFERENDUM NO. 371,FOR THE PROPOSAL - YES,600103,20,16,476,512
PAYNE,STATE QUESTION NO. 794 LEGISLATIVE REFERENDUM NO. 371,AGAINST THE PROPOSAL - NO,600103,1,6,111,118
PAYNE,STATE QUESTION NO. 794 LEGISLATIVE REFERENDUM NO. 371,FOR THE PROPOSAL - YES,600104,18,14,550,582
PAYNE,STATE QUESTION NO. 794 LEGISLATIVE REFERENDUM NO. 371,AGAINST THE PROPOSAL - NO,600104,2,7,119,128
PAYNE,STATE QUESTION NO. 794 LEGISLATIVE REFERENDUM NO. 371,FOR THE PROPOSAL - YES,600201,17,22,542,581
PAYNE,STATE QUESTION NO. 794 LEGISLATIVE REFERENDUM NO. 371,AGAINST THE PROPOSAL - NO,600201,5,4,110,119
PAYNE,STATE QUESTION NO. 794 LEGISLATIVE REFERENDUM NO. 371,FOR THE PROPOSAL - YES,600301,48,105,1146,1299
PAYNE,STATE QUESTION NO. 794 LEGISLATIVE REFERENDUM NO. 371,AGAINST THE PROPOSAL - NO,600301,14,17,270,301
PAYNE,STATE QUESTION NO. 794 LEGISLATIVE REFERENDUM NO. 371,FOR THE PROPOSAL - YES,600401,56,201,1064,1321
PAYNE,STATE QUESTION NO. 794 LEGISLATIVE REFERENDUM NO. 371,AGAINST THE PROPOSAL - NO,600401,24,76,326,426
PAYNE,STATE QUESTION NO. 794 LEGISLATIVE REFERENDUM NO. 371,FOR THE PROPOSAL - YES,600402,26,90,421,537
PAYNE,STATE QUESTION NO. 794 LEGISLATIVE REFERENDUM NO. 371,AGAINST THE PROPOSAL - NO,600402,6,21,136,163
PAYNE,STATE QUESTION NO. 794 LEGISLATIVE REFERENDUM NO. 371,FOR THE PROPOSAL - YES,600403,16,72,393,481
PAYNE,STATE QUESTION NO. 794 LEGISLATIVE REFERENDUM NO. 371,AGAINST THE PROPOSAL - NO,600403,8,15,120,143
PAYNE,STATE QUESTION NO. 794 LEGISLATIVE REFERENDUM NO. 371,FOR THE PROPOSAL - YES,600404,5,19,78,102
PAYNE,STATE QUESTION NO. 794 LEGISLATIVE REFERENDUM NO. 371,AGAINST THE PROPOSAL - NO,600404,3,3,28,34
PAYNE,STATE QUESTION NO. 794 LEGISLATIVE REFERENDUM NO. 371,FOR THE PROPOSAL - YES,600405,32,123,613,768
PAYNE,STATE QUESTION NO. 794 LEGISLATIVE REFERENDUM NO. 371,AGAINST THE PROPOSAL - NO,600405,5,31,147,183
PAYNE,STATE QUESTION NO. 794 LEGISLATIVE REFERENDUM NO. 371,FOR THE PROPOSAL - YES,600406,19,35,452,506
PAYNE,STATE QUESTION NO. 794 LEGISLATIVE REFERENDUM NO. 371,AGAINST THE PROPOSAL - NO,600406,8,8,112,128
PAYNE,STATE QUESTION NO. 794 LEGISLATIVE REFERENDUM NO. 371,FOR THE PROPOSAL - YES,600407,19,83,560,662
PAYNE,STATE QUESTION NO. 794 LEGISLATIVE REFERENDUM NO. 371,AGAINST THE PROPOSAL - NO,600407,4,24,139,167
PAYNE,STATE QUESTION NO. 794 LEGISLATIVE REFERENDUM NO. 371,FOR THE PROPOSAL - YES,600408,7,13,185,205
PAYNE,STATE QUESTION NO. 794 LEGISLATIVE REFERENDUM NO. 371,AGAINST THE PROPOSAL - NO,600408,0,7,35,42
PAYNE,STATE QUESTION NO. 794 LEGISLATIVE REFERENDUM NO. 371,FOR THE PROPOSAL - YES,600409,16,55,506,577
PAYNE,STATE QUESTION NO. 794 LEGISLATIVE REFERENDUM NO. 371,AGAINST THE PROPOSAL - NO,600409,1,11,111,123
PITTSBURG,STATE QUESTION NO. 794 LEGISLATIVE REFERENDUM NO. 371,FOR THE PROPOSAL - YES,610001,1,3,40,44
PITTSBURG,STATE QUESTION NO. 794 LEGISLATIVE REFERENDUM NO. 371,AGAINST THE PROPOSAL - NO,610001,0,0,15,15
PITTSBURG,STATE QUESTION NO. 794 LEGISLATIVE REFERENDUM NO. 371,FOR THE PROPOSAL - YES,610003,15,44,288,347
PITTSBURG,STATE QUESTION NO. 794 LEGISLATIVE REFERENDUM NO. 371,AGAINST THE PROPOSAL - NO,610003,7,17,79,103
PITTSBURG,STATE QUESTION NO. 794 LEGISLATIVE REFERENDUM NO. 371,FOR THE PROPOSAL - YES,610004,12,86,514,612
PITTSBURG,STATE QUESTION NO. 794 LEGISLATIVE REFERENDUM NO. 371,AGAINST THE PROPOSAL - NO,610004,2,11,124,137
PITTSBURG,STATE QUESTION NO. 794 LEGISLATIVE REFERENDUM NO. 371,FOR THE PROPOSAL - YES,610005,7,37,236,280
PITTSBURG,STATE QUESTION NO. 794 LEGISLATIVE REFERENDUM NO. 371,AGAINST THE PROPOSAL - NO,610005,3,4,63,70
PITTSBURG,STATE QUESTION NO. 794 LEGISLATIVE REFERENDUM NO. 371,FOR THE PROPOSAL - YES,610006,7,34,262,303
PITTSBURG,STATE QUESTION NO. 794 LEGISLATIVE REFERENDUM NO. 371,AGAINST THE PROPOSAL - NO,610006,3,8,89,100
PITTSBURG,STATE QUESTION NO. 794 LEGISLATIVE REFERENDUM NO. 371,FOR THE PROPOSAL - YES,610007,14,34,293,341
PITTSBURG,STATE QUESTION NO. 794 LEGISLATIVE REFERENDUM NO. 371,AGAINST THE PROPOSAL - NO,610007,2,8,68,78
PITTSBURG,STATE QUESTION NO. 794 LEGISLATIVE REFERENDUM NO. 371,FOR THE PROPOSAL - YES,610008,2,17,216,235
PITTSBURG,STATE QUESTION NO. 794 LEGISLATIVE REFERENDUM NO. 371,AGAINST THE PROPOSAL - NO,610008,2,6,56,64
PITTSBURG,STATE QUESTION NO. 794 LEGISLATIVE REFERENDUM NO. 371,FOR THE PROPOSAL - YES,610011,18,54,426,498
PITTSBURG,STATE QUESTION NO. 794 LEGISLATIVE REFERENDUM NO. 371,AGAINST THE PROPOSAL - NO,610011,7,13,127,147
PITTSBURG,STATE QUESTION NO. 794 LEGISLATIVE REFERENDUM NO. 371,FOR THE PROPOSAL - YES,610014,11,55,437,503
PITTSBURG,STATE QUESTION NO. 794 LEGISLATIVE REFERENDUM NO. 371,AGAINST THE PROPOSAL - NO,610014,7,18,110,135
PITTSBURG,STATE QUESTION NO. 794 LEGISLATIVE REFERENDUM NO. 371,FOR THE PROPOSAL - YES,610015,3,10,78,91
PITTSBURG,STATE QUESTION NO. 794 LEGISLATIVE REFERENDUM NO. 371,AGAINST THE PROPOSAL - NO,610015,0,4,22,26
PITTSBURG,STATE QUESTION NO. 794 LEGISLATIVE REFERENDUM NO. 371,FOR THE PROPOSAL - YES,610019,4,13,138,155
PITTSBURG,STATE QUESTION NO. 794 LEGISLATIVE REFERENDUM NO. 371,AGAINST THE PROPOSAL - NO,610019,1,1,26,28
PITTSBURG,STATE QUESTION NO. 794 LEGISLATIVE REFERENDUM NO. 371,FOR THE PROPOSAL - YES,610020,0,8,51,59
PITTSBURG,STATE QUESTION NO. 794 LEGISLATIVE REFERENDUM NO. 371,AGAINST THE PROPOSAL - NO,610020,2,1,16,19
PITTSBURG,STATE QUESTION NO. 794 LEGISLATIVE REFERENDUM NO. 371,FOR THE PROPOSAL - YES,610021,9,43,333,385
PITTSBURG,STATE QUESTION NO. 794 LEGISLATIVE REFERENDUM NO. 371,AGAINST THE PROPOSAL - NO,610021,2,18,99,119
PITTSBURG,STATE QUESTION NO. 794 LEGISLATIVE REFERENDUM NO. 371,FOR THE PROPOSAL - YES,610023,1,2,75,78
PITTSBURG,STATE QUESTION NO. 794 LEGISLATIVE REFERENDUM NO. 371,AGAINST THE PROPOSAL - NO,610023,0,0,20,20
PITTSBURG,STATE QUESTION NO. 794 LEGISLATIVE REFERENDUM NO. 371,FOR THE PROPOSAL - YES,610026,6,17,245,268
PITTSBURG,STATE QUESTION NO. 794 LEGISLATIVE REFERENDUM NO. 371,AGAINST THE PROPOSAL - NO,610026,2,2,45,49
PITTSBURG,STATE QUESTION NO. 794 LEGISLATIVE REFERENDUM NO. 371,FOR THE PROPOSAL - YES,610027,32,32,613,677
PITTSBURG,STATE QUESTION NO. 794 LEGISLATIVE REFERENDUM NO. 371,AGAINST THE PROPOSAL - NO,610027,8,9,117,134
PITTSBURG,STATE QUESTION NO. 794 LEGISLATIVE REFERENDUM NO. 371,FOR THE PROPOSAL - YES,610028,7,0,119,126
PITTSBURG,STATE QUESTION NO. 794 LEGISLATIVE REFERENDUM NO. 371,AGAINST THE PROPOSAL - NO,610028,0,0,42,42
PITTSBURG,STATE QUESTION NO. 794 LEGISLATIVE REFERENDUM NO. 371,FOR THE PROPOSAL - YES,610029,1,8,171,180
PITTSBURG,STATE QUESTION NO. 794 LEGISLATIVE REFERENDUM NO. 371,AGAINST THE PROPOSAL - NO,610029,2,0,41,43
PITTSBURG,STATE QUESTION NO. 794 LEGISLATIVE REFERENDUM NO. 371,FOR THE PROPOSAL - YES,610030,3,9,127,139
PITTSBURG,STATE QUESTION NO. 794 LEGISLATIVE REFERENDUM NO. 371,AGAINST THE PROPOSAL - NO,610030,1,1,38,40
PITTSBURG,STATE QUESTION NO. 794 LEGISLATIVE REFERENDUM NO. 371,FOR THE PROPOSAL - YES,610031,13,14,266,293
PITTSBURG,STATE QUESTION NO. 794 LEGISLATIVE REFERENDUM NO. 371,AGAINST THE PROPOSAL - NO,610031,8,3,58,69
PITTSBURG,STATE QUESTION NO. 794 LEGISLATIVE REFERENDUM NO. 371,FOR THE PROPOSAL - YES,610032,30,95,504,629
PITTSBURG,STATE QUESTION NO. 794 LEGISLATIVE REFERENDUM NO. 371,AGAINST THE PROPOSAL - NO,610032,3,39,129,171
PITTSBURG,STATE QUESTION NO. 794 LEGISLATIVE REFERENDUM NO. 371,FOR THE PROPOSAL - YES,610033,1,17,189,207
PITTSBURG,STATE QUESTION NO. 794 LEGISLATIVE REFERENDUM NO. 371,AGAINST THE PROPOSAL - NO,610033,1,0,51,52
PITTSBURG,STATE QUESTION NO. 794 LEGISLATIVE REFERENDUM NO. 371,FOR THE PROPOSAL - YES,610034,9,16,393,418
PITTSBURG,STATE QUESTION NO. 794 LEGISLATIVE REFERENDUM NO. 371,AGAINST THE PROPOSAL - NO,610034,2,5,85,92
PITTSBURG,STATE QUESTION NO. 794 LEGISLATIVE REFERENDUM NO. 371,FOR THE PROPOSAL - YES,610035,5,4,245,254
PITTSBURG,STATE QUESTION NO. 794 LEGISLATIVE REFERENDUM NO. 371,AGAINST THE PROPOSAL - NO,610035,2,3,55,60
PITTSBURG,STATE QUESTION NO. 794 LEGISLATIVE REFERENDUM NO. 371,FOR THE PROPOSAL - YES,610036,2,21,102,125
PITTSBURG,STATE QUESTION NO. 794 LEGISLATIVE REFERENDUM NO. 371,AGAINST THE PROPOSAL - NO,610036,0,6,22,28
PITTSBURG,STATE QUESTION NO. 794 LEGISLATIVE REFERENDUM NO. 371,FOR THE PROPOSAL - YES,610037,5,30,397,432
PITTSBURG,STATE QUESTION NO. 794 LEGISLATIVE REFERENDUM NO. 371,AGAINST THE PROPOSAL - NO,610037,2,11,102,115
PITTSBURG,STATE QUESTION NO. 794 LEGISLATIVE REFERENDUM NO. 371,FOR THE PROPOSAL - YES,610038,0,1,16,17
PITTSBURG,STATE QUESTION NO. 794 LEGISLATIVE REFERENDUM NO. 371,AGAINST THE PROPOSAL - NO,610038,2,1,11,14
PITTSBURG,STATE QUESTION NO. 794 LEGISLATIVE REFERENDUM NO. 371,FOR THE PROPOSAL - YES,610039,5,7,232,244
PITTSBURG,STATE QUESTION NO. 794 LEGISLATIVE REFERENDUM NO. 371,AGAINST THE PROPOSAL - NO,610039,1,0,64,65
PITTSBURG,STATE QUESTION NO. 794 LEGISLATIVE REFERENDUM NO. 371,FOR THE PROPOSAL - YES,610040,4,5,226,235
PITTSBURG,STATE QUESTION NO. 794 LEGISLATIVE REFERENDUM NO. 371,AGAINST THE PROPOSAL - NO,610040,1,6,59,66
PITTSBURG,STATE QUESTION NO. 794 LEGISLATIVE REFERENDUM NO. 371,FOR THE PROPOSAL - YES,610041,7,24,438,469
PITTSBURG,STATE QUESTION NO. 794 LEGISLATIVE REFERENDUM NO. 371,AGAINST THE PROPOSAL - NO,610041,11,11,91,113
PITTSBURG,STATE QUESTION NO. 794 LEGISLATIVE REFERENDUM NO. 371,FOR THE PROPOSAL - YES,610042,10,68,276,354
PITTSBURG,STATE QUESTION NO. 794 LEGISLATIVE REFERENDUM NO. 371,AGAINST THE PROPOSAL - NO,610042,1,14,62,77
PITTSBURG,STATE QUESTION NO. 794 LEGISLATIVE REFERENDUM NO. 371,FOR THE PROPOSAL - YES,610043,3,8,179,190
PITTSBURG,STATE QUESTION NO. 794 LEGISLATIVE REFERENDUM NO. 371,AGAINST THE PROPOSAL - NO,610043,3,1,50,54
PITTSBURG,STATE QUESTION NO. 794 LEGISLATIVE REFERENDUM NO. 371,FOR THE PROPOSAL - YES,610044,11,2,283,296
PITTSBURG,STATE QUESTION NO. 794 LEGISLATIVE REFERENDUM NO. 371,AGAINST THE PROPOSAL - NO,610044,4,3,73,80
PITTSBURG,STATE QUESTION NO. 794 LEGISLATIVE REFERENDUM NO. 371,FOR THE PROPOSAL - YES,610045,0,2,7,9
PITTSBURG,STATE QUESTION NO. 794 LEGISLATIVE REFERENDUM NO. 371,AGAINST THE PROPOSAL - NO,610045,0,0,0,0
PITTSBURG,STATE QUESTION NO. 794 LEGISLATIVE REFERENDUM NO. 371,FOR THE PROPOSAL - YES,610046,3,25,125,153
PITTSBURG,STATE QUESTION NO. 794 LEGISLATIVE REFERENDUM NO. 371,AGAINST THE PROPOSAL - NO,610046,0,6,32,38
PITTSBURG,STATE QUESTION NO. 794 LEGISLATIVE REFERENDUM NO. 371,FOR THE PROPOSAL - YES,610047,3,11,256,270
PITTSBURG,STATE QUESTION NO. 794 LEGISLATIVE REFERENDUM NO. 371,AGAINST THE PROPOSAL - NO,610047,5,5,52,62
PITTSBURG,STATE QUESTION NO. 794 LEGISLATIVE REFERENDUM NO. 371,FOR THE PROPOSAL - YES,610048,0,3,76,79
PITTSBURG,STATE QUESTION NO. 794 LEGISLATIVE REFERENDUM NO. 371,AGAINST THE PROPOSAL - NO,610048,0,3,15,18
PITTSBURG,STATE QUESTION NO. 794 LEGISLATIVE REFERENDUM NO. 371,FOR THE PROPOSAL - YES,610049,5,35,267,307
PITTSBURG,STATE QUESTION NO. 794 LEGISLATIVE REFERENDUM NO. 371,AGAINST THE PROPOSAL - NO,610049,5,7,68,80
PITTSBURG,STATE QUESTION NO. 794 LEGISLATIVE REFERENDUM NO. 371,FOR THE PROPOSAL - YES,610051,3,4,131,138
PITTSBURG,STATE QUESTION NO. 794 LEGISLATIVE REFERENDUM NO. 371,AGAINST THE PROPOSAL - NO,610051,1,1,44,46
PITTSBURG,STATE QUESTION NO. 794 LEGISLATIVE REFERENDUM NO. 371,FOR THE PROPOSAL - YES,610052,0,1,6,7
PITTSBURG,STATE QUESTION NO. 794 LEGISLATIVE REFERENDUM NO. 371,AGAINST THE PROPOSAL - NO,610052,0,0,6,6
PITTSBURG,STATE QUESTION NO. 794 LEGISLATIVE REFERENDUM NO. 371,FOR THE PROPOSAL - YES,610053,0,0,44,44
PITTSBURG,STATE QUESTION NO. 794 LEGISLATIVE REFERENDUM NO. 371,AGAINST THE PROPOSAL - NO,610053,0,0,11,11
PONTOTOC,STATE QUESTION NO. 794 LEGISLATIVE REFERENDUM NO. 371,FOR THE PROPOSAL - YES,620013,23,129,455,607
PONTOTOC,STATE QUESTION NO. 794 LEGISLATIVE REFERENDUM NO. 371,AGAINST THE PROPOSAL - NO,620013,10,53,163,226
PONTOTOC,STATE QUESTION NO. 794 LEGISLATIVE REFERENDUM NO. 371,FOR THE PROPOSAL - YES,620016,27,199,624,850
PONTOTOC,STATE QUESTION NO. 794 LEGISLATIVE REFERENDUM NO. 371,AGAINST THE PROPOSAL - NO,620016,13,76,209,298
PONTOTOC,STATE QUESTION NO. 794 LEGISLATIVE REFERENDUM NO. 371,FOR THE PROPOSAL - YES,620022,26,70,388,484
PONTOTOC,STATE QUESTION NO. 794 LEGISLATIVE REFERENDUM NO. 371,AGAINST THE PROPOSAL - NO,620022,4,29,134,167
PONTOTOC,STATE QUESTION NO. 794 LEGISLATIVE REFERENDUM NO. 371,FOR THE PROPOSAL - YES,620025,23,139,660,822
PONTOTOC,STATE QUESTION NO. 794 LEGISLATIVE REFERENDUM NO. 371,AGAINST THE PROPOSAL - NO,620025,4,45,208,257
PONTOTOC,STATE QUESTION NO. 794 LEGISLATIVE REFERENDUM NO. 371,FOR THE PROPOSAL - YES,620031,9,127,521,657
PONTOTOC,STATE QUESTION NO. 794 LEGISLATIVE REFERENDUM NO. 371,AGAINST THE PROPOSAL - NO,620031,7,31,203,241
PONTOTOC,STATE QUESTION NO. 794 LEGISLATIVE REFERENDUM NO. 371,FOR THE PROPOSAL - YES,620051,1,7,235,243
PONTOTOC,STATE QUESTION NO. 794 LEGISLATIVE REFERENDUM NO. 371,AGAINST THE PROPOSAL - NO,620051,2,4,62,68
PONTOTOC,STATE QUESTION NO. 794 LEGISLATIVE REFERENDUM NO. 371,FOR THE PROPOSAL - YES,620052,10,55,293,358
PONTOTOC,STATE QUESTION NO. 794 LEGISLATIVE REFERENDUM NO. 371,AGAINST THE PROPOSAL - NO,620052,4,9,94,107
PONTOTOC,STATE QUESTION NO. 794 LEGISLATIVE REFERENDUM NO. 371,FOR THE PROPOSAL - YES,620053,30,200,589,819
PONTOTOC,STATE QUESTION NO. 794 LEGISLATIVE REFERENDUM NO. 371,AGAINST THE PROPOSAL - NO,620053,12,63,221,296
PONTOTOC,STATE QUESTION NO. 794 LEGISLATIVE REFERENDUM NO. 371,FOR THE PROPOSAL - YES,620054,1,9,87,97
PONTOTOC,STATE QUESTION NO. 794 LEGISLATIVE REFERENDUM NO. 371,AGAINST THE PROPOSAL - NO,620054,2,1,29,32
PONTOTOC,STATE QUESTION NO. 794 LEGISLATIVE REFERENDUM NO. 371,FOR THE PROPOSAL - YES,620055,4,26,104,134
PONTOTOC,STATE QUESTION NO. 794 LEGISLATIVE REFERENDUM NO. 371,AGAINST THE PROPOSAL - NO,620055,2,11,35,48
PONTOTOC,STATE QUESTION NO. 794 LEGISLATIVE REFERENDUM NO. 371,FOR THE PROPOSAL - YES,620056,6,11,153,170
PONTOTOC,STATE QUESTION NO. 794 LEGISLATIVE REFERENDUM NO. 371,AGAINST THE PROPOSAL - NO,620056,0,4,72,76
PONTOTOC,STATE QUESTION NO. 794 LEGISLATIVE REFERENDUM NO. 371,FOR THE PROPOSAL - YES,620058,13,39,481,533
PONTOTOC,STATE QUESTION NO. 794 LEGISLATIVE REFERENDUM NO. 371,AGAINST THE PROPOSAL - NO,620058,4,31,159,194
PONTOTOC,STATE QUESTION NO. 794 LEGISLATIVE REFERENDUM NO. 371,FOR THE PROPOSAL - YES,620059,10,27,294,331
PONTOTOC,STATE QUESTION NO. 794 LEGISLATIVE REFERENDUM NO. 371,AGAINST THE PROPOSAL - NO,620059,1,4,103,108
PONTOTOC,STATE QUESTION NO. 794 LEGISLATIVE REFERENDUM NO. 371,FOR THE PROPOSAL - YES,620060,10,55,470,535
PONTOTOC,STATE QUESTION NO. 794 LEGISLATIVE REFERENDUM NO. 371,AGAINST THE PROPOSAL - NO,620060,6,21,153,180
PONTOTOC,STATE QUESTION NO. 794 LEGISLATIVE REFERENDUM NO. 371,FOR THE PROPOSAL - YES,620061,1,29,128,158
PONTOTOC,STATE QUESTION NO. 794 LEGISLATIVE REFERENDUM NO. 371,AGAINST THE PROPOSAL - NO,620061,0,5,49,54
PONTOTOC,STATE QUESTION NO. 794 LEGISLATIVE REFERENDUM NO. 371,FOR THE PROPOSAL - YES,620062,9,52,362,423
PONTOTOC,STATE QUESTION NO. 794 LEGISLATIVE REFERENDUM NO. 371,AGAINST THE PROPOSAL - NO,620062,2,11,98,111
PONTOTOC,STATE QUESTION NO. 794 LEGISLATIVE REFERENDUM NO. 371,FOR THE PROPOSAL - YES,620063,3,6,209,218
PONTOTOC,STATE QUESTION NO. 794 LEGISLATIVE REFERENDUM NO. 371,AGAINST THE PROPOSAL - NO,620063,4,3,57,64
PONTOTOC,STATE QUESTION NO. 794 LEGISLATIVE REFERENDUM NO. 371,FOR THE PROPOSAL - YES,620064,6,42,313,361
PONTOTOC,STATE QUESTION NO. 794 LEGISLATIVE REFERENDUM NO. 371,AGAINST THE PROPOSAL - NO,620064,2,13,112,127
PONTOTOC,STATE QUESTION NO. 794 LEGISLATIVE REFERENDUM NO. 371,FOR THE PROPOSAL - YES,620065,6,20,304,330
PONTOTOC,STATE QUESTION NO. 794 LEGISLATIVE REFERENDUM NO. 371,AGAINST THE PROPOSAL - NO,620065,1,1,65,67
PONTOTOC,STATE QUESTION NO. 794 LEGISLATIVE REFERENDUM NO. 371,FOR THE PROPOSAL - YES,620066,7,41,300,348
PONTOTOC,STATE QUESTION NO. 794 LEGISLATIVE REFERENDUM NO. 371,AGAINST THE PROPOSAL - NO,620066,4,9,128,141
PONTOTOC,STATE QUESTION NO. 794 LEGISLATIVE REFERENDUM NO. 371,FOR THE PROPOSAL - YES,620067,8,13,189,210
PONTOTOC,STATE QUESTION NO. 794 LEGISLATIVE REFERENDUM NO. 371,AGAINST THE PROPOSAL - NO,620067,3,8,72,83
POTTAWATOMIE,STATE QUESTION NO. 794 LEGISLATIVE REFERENDUM NO. 371,FOR THE PROPOSAL - YES,630001,25,35,280,340
POTTAWATOMIE,STATE QUESTION NO. 794 LEGISLATIVE REFERENDUM NO. 371,AGAINST THE PROPOSAL - NO,630001,2,5,47,54
POTTAWATOMIE,STATE QUESTION NO. 794 LEGISLATIVE REFERENDUM NO. 371,FOR THE PROPOSAL - YES,630002,22,23,334,379
POTTAWATOMIE,STATE QUESTION NO. 794 LEGISLATIVE REFERENDUM NO. 371,AGAINST THE PROPOSAL - NO,630002,4,7,77,88
POTTAWATOMIE,STATE QUESTION NO. 794 LEGISLATIVE REFERENDUM NO. 371,FOR THE PROPOSAL - YES,630003,40,61,578,679
POTTAWATOMIE,STATE QUESTION NO. 794 LEGISLATIVE REFERENDUM NO. 371,AGAINST THE PROPOSAL - NO,630003,6,15,109,130
POTTAWATOMIE,STATE QUESTION NO. 794 LEGISLATIVE REFERENDUM NO. 371,FOR THE PROPOSAL - YES,630006,32,63,386,481
POTTAWATOMIE,STATE QUESTION NO. 794 LEGISLATIVE REFERENDUM NO. 371,AGAINST THE PROPOSAL - NO,630006,7,15,113,135
POTTAWATOMIE,STATE QUESTION NO. 794 LEGISLATIVE REFERENDUM NO. 371,FOR THE PROPOSAL - YES,630007,41,83,530,654
POTTAWATOMIE,STATE QUESTION NO. 794 LEGISLATIVE REFERENDUM NO. 371,AGAINST THE PROPOSAL - NO,630007,16,21,104,141
POTTAWATOMIE,STATE QUESTION NO. 794 LEGISLATIVE REFERENDUM NO. 371,FOR THE PROPOSAL - YES,630009,74,187,662,923
POTTAWATOMIE,STATE QUESTION NO. 794 LEGISLATIVE REFERENDUM NO. 371,AGAINST THE PROPOSAL - NO,630009,23,49,159,231
POTTAWATOMIE,STATE QUESTION NO. 794 LEGISLATIVE REFERENDUM NO. 371,FOR THE PROPOSAL - YES,630011,84,133,964,1181
POTTAWATOMIE,STATE QUESTION NO. 794 LEGISLATIVE REFERENDUM NO. 371,AGAINST THE PROPOSAL - NO,630011,18,34,236,288
POTTAWATOMIE,STATE QUESTION NO. 794 LEGISLATIVE REFERENDUM NO. 371,FOR THE PROPOSAL - YES,630012,56,88,540,684
POTTAWATOMIE,STATE QUESTION NO. 794 LEGISLATIVE REFERENDUM NO. 371,AGAINST THE PROPOSAL - NO,630012,8,27,163,198
POTTAWATOMIE,STATE QUESTION NO. 794 LEGISLATIVE REFERENDUM NO. 371,FOR THE PROPOSAL - YES,630013,98,158,707,963
POTTAWATOMIE,STATE QUESTION NO. 794 LEGISLATIVE REFERENDUM NO. 371,AGAINST THE PROPOSAL - NO,630013,15,36,196,247
POTTAWATOMIE,STATE QUESTION NO. 794 LEGISLATIVE REFERENDUM NO. 371,FOR THE PROPOSAL - YES,630015,48,96,673,817
POTTAWATOMIE,STATE QUESTION NO. 794 LEGISLATIVE REFERENDUM NO. 371,AGAINST THE PROPOSAL - NO,630015,11,21,144,176
POTTAWATOMIE,STATE QUESTION NO. 794 LEGISLATIVE REFERENDUM NO. 371,FOR THE PROPOSAL - YES,630018,50,63,626,739
POTTAWATOMIE,STATE QUESTION NO. 794 LEGISLATIVE REFERENDUM NO. 371,AGAINST THE PROPOSAL - NO,630018,17,15,108,140
POTTAWATOMIE,STATE QUESTION NO. 794 LEGISLATIVE REFERENDUM NO. 371,FOR THE PROPOSAL - YES,630021,25,27,389,441
POTTAWATOMIE,STATE QUESTION NO. 794 LEGISLATIVE REFERENDUM NO. 371,AGAINST THE PROPOSAL - NO,630021,7,5,81,93
POTTAWATOMIE,STATE QUESTION NO. 794 LEGISLATIVE REFERENDUM NO. 371,FOR THE PROPOSAL - YES,630022,59,119,758,936
POTTAWATOMIE,STATE QUESTION NO. 794 LEGISLATIVE REFERENDUM NO. 371,AGAINST THE PROPOSAL - NO,630022,13,32,182,227
POTTAWATOMIE,STATE QUESTION NO. 794 LEGISLATIVE REFERENDUM NO. 371,FOR THE PROPOSAL - YES,630024,61,81,777,919
POTTAWATOMIE,STATE QUESTION NO. 794 LEGISLATIVE REFERENDUM NO. 371,AGAINST THE PROPOSAL - NO,630024,15,20,171,206
POTTAWATOMIE,STATE QUESTION NO. 794 LEGISLATIVE REFERENDUM NO. 371,FOR THE PROPOSAL - YES,630025,41,32,524,597
POTTAWATOMIE,STATE QUESTION NO. 794 LEGISLATIVE REFERENDUM NO. 371,AGAINST THE PROPOSAL - NO,630025,10,4,103,117
POTTAWATOMIE,STATE QUESTION NO. 794 LEGISLATIVE REFERENDUM NO. 371,FOR THE PROPOSAL - YES,630026,40,80,453,573
POTTAWATOMIE,STATE QUESTION NO. 794 LEGISLATIVE REFERENDUM NO. 371,AGAINST THE PROPOSAL - NO,630026,4,8,137,149
POTTAWATOMIE,STATE QUESTION NO. 794 LEGISLATIVE REFERENDUM NO. 371,FOR THE PROPOSAL - YES,630027,20,21,477,518
POTTAWATOMIE,STATE QUESTION NO. 794 LEGISLATIVE REFERENDUM NO. 371,AGAINST THE PROPOSAL - NO,630027,4,8,86,98
POTTAWATOMIE,STATE QUESTION NO. 794 LEGISLATIVE REFERENDUM NO. 371,FOR THE PROPOSAL - YES,630029,48,97,654,799
POTTAWATOMIE,STATE QUESTION NO. 794 LEGISLATIVE REFERENDUM NO. 371,AGAINST THE PROPOSAL - NO,630029,17,12,141,170
POTTAWATOMIE,STATE QUESTION NO. 794 LEGISLATIVE REFERENDUM NO. 371,FOR THE PROPOSAL - YES,630030,56,88,962,1106
POTTAWATOMIE,STATE QUESTION NO. 794 LEGISLATIVE REFERENDUM NO. 371,AGAINST THE PROPOSAL - NO,630030,16,25,220,261
POTTAWATOMIE,STATE QUESTION NO. 794 LEGISLATIVE REFERENDUM NO. 371,FOR THE PROPOSAL - YES,630031,94,174,1135,1403
POTTAWATOMIE,STATE QUESTION NO. 794 LEGISLATIVE REFERENDUM NO. 371,AGAINST THE PROPOSAL - NO,630031,30,35,284,349
POTTAWATOMIE,STATE QUESTION NO. 794 LEGISLATIVE REFERENDUM NO. 371,FOR THE PROPOSAL - YES,630033,7,20,324,351
POTTAWATOMIE,STATE QUESTION NO. 794 LEGISLATIVE REFERENDUM NO. 371,AGAINST THE PROPOSAL - NO,630033,2,7,75,84
POTTAWATOMIE,STATE QUESTION NO. 794 LEGISLATIVE REFERENDUM NO. 371,FOR THE PROPOSAL - YES,630037,18,9,324,351
POTTAWATOMIE,STATE QUESTION NO. 794 LEGISLATIVE REFERENDUM NO. 371,AGAINST THE PROPOSAL - NO,630037,7,3,68,78
POTTAWATOMIE,STATE QUESTION NO. 794 LEGISLATIVE REFERENDUM NO. 371,FOR THE PROPOSAL - YES,630038,11,25,223,259
POTTAWATOMIE,STATE QUESTION NO. 794 LEGISLATIVE REFERENDUM NO. 371,AGAINST THE PROPOSAL - NO,630038,1,5,65,71
POTTAWATOMIE,STATE QUESTION NO. 794 LEGISLATIVE REFERENDUM NO. 371,FOR THE PROPOSAL - YES,630040,19,8,224,251
POTTAWATOMIE,STATE QUESTION NO. 794 LEGISLATIVE REFERENDUM NO. 371,AGAINST THE PROPOSAL - NO,630040,0,3,55,58
POTTAWATOMIE,STATE QUESTION NO. 794 LEGISLATIVE REFERENDUM NO. 371,FOR THE PROPOSAL - YES,630041,15,10,284,309
POTTAWATOMIE,STATE QUESTION NO. 794 LEGISLATIVE REFERENDUM NO. 371,AGAINST THE PROPOSAL - NO,630041,3,2,76,81
POTTAWATOMIE,STATE QUESTION NO. 794 LEGISLATIVE REFERENDUM NO. 371,FOR THE PROPOSAL - YES,630042,9,4,174,187
POTTAWATOMIE,STATE QUESTION NO. 794 LEGISLATIVE REFERENDUM NO. 371,AGAINST THE PROPOSAL - NO,630042,0,0,36,36
PUSHMATAHA,STATE QUESTION NO. 794 LEGISLATIVE REFERENDUM NO. 371,FOR THE PROPOSAL - YES,640001,4,17,181,202
PUSHMATAHA,STATE QUESTION NO. 794 LEGISLATIVE REFERENDUM NO. 371,AGAINST THE PROPOSAL - NO,640001,0,4,37,41
PUSHMATAHA,STATE QUESTION NO. 794 LEGISLATIVE REFERENDUM NO. 371,FOR THE PROPOSAL - YES,640002,15,98,325,438
PUSHMATAHA,STATE QUESTION NO. 794 LEGISLATIVE REFERENDUM NO. 371,AGAINST THE PROPOSAL - NO,640002,1,19,101,121
PUSHMATAHA,STATE QUESTION NO. 794 LEGISLATIVE REFERENDUM NO. 371,FOR THE PROPOSAL - YES,640003,1,26,201,228
PUSHMATAHA,STATE QUESTION NO. 794 LEGISLATIVE REFERENDUM NO. 371,AGAINST THE PROPOSAL - NO,640003,0,10,41,51
PUSHMATAHA,STATE QUESTION NO. 794 LEGISLATIVE REFERENDUM NO. 371,FOR THE PROPOSAL - YES,640004,15,45,224,284
PUSHMATAHA,STATE QUESTION NO. 794 LEGISLATIVE REFERENDUM NO. 371,AGAINST THE PROPOSAL - NO,640004,1,18,56,75
PUSHMATAHA,STATE QUESTION NO. 794 LEGISLATIVE REFERENDUM NO. 371,FOR THE PROPOSAL - YES,640005,2,3,38,43
PUSHMATAHA,STATE QUESTION NO. 794 LEGISLATIVE REFERENDUM NO. 371,AGAINST THE PROPOSAL - NO,640005,1,2,17,20
PUSHMATAHA,STATE QUESTION NO. 794 LEGISLATIVE REFERENDUM NO. 371,FOR THE PROPOSAL - YES,640007,4,8,88,100
PUSHMATAHA,STATE QUESTION NO. 794 LEGISLATIVE REFERENDUM NO. 371,AGAINST THE PROPOSAL - NO,640007,0,1,21,22
PUSHMATAHA,STATE QUESTION NO. 794 LEGISLATIVE REFERENDUM NO. 371,FOR THE PROPOSAL - YES,640008,1,7,89,97
PUSHMATAHA,STATE QUESTION NO. 794 LEGISLATIVE REFERENDUM NO. 371,AGAINST THE PROPOSAL - NO,640008,1,1,20,22
PUSHMATAHA,STATE QUESTION NO. 794 LEGISLATIVE REFERENDUM NO. 371,FOR THE PROPOSAL - YES,640009,4,2,73,79
PUSHMATAHA,STATE QUESTION NO. 794 LEGISLATIVE REFERENDUM NO. 371,AGAINST THE PROPOSAL - NO,640009,1,2,45,48
PUSHMATAHA,STATE QUESTION NO. 794 LEGISLATIVE REFERENDUM NO. 371,FOR THE PROPOSAL - YES,640010,4,2,55,61
PUSHMATAHA,STATE QUESTION NO. 794 LEGISLATIVE REFERENDUM NO. 371,AGAINST THE PROPOSAL - NO,640010,2,4,17,23
PUSHMATAHA,STATE QUESTION NO. 794 LEGISLATIVE REFERENDUM NO. 371,FOR THE PROPOSAL - YES,640011,3,19,264,286
PUSHMATAHA,STATE QUESTION NO. 794 LEGISLATIVE REFERENDUM NO. 371,AGAINST THE PROPOSAL - NO,640011,4,2,112,118
PUSHMATAHA,STATE QUESTION NO. 794 LEGISLATIVE REFERENDUM NO. 371,FOR THE PROPOSAL - YES,640012,4,1,57,62
PUSHMATAHA,STATE QUESTION NO. 794 LEGISLATIVE REFERENDUM NO. 371,AGAINST THE PROPOSAL - NO,640012,0,0,18,18
PUSHMATAHA,STATE QUESTION NO. 794 LEGISLATIVE REFERENDUM NO. 371,FOR THE PROPOSAL - YES,640013,0,0,24,24
PUSHMATAHA,STATE QUESTION NO. 794 LEGISLATIVE REFERENDUM NO. 371,AGAINST THE PROPOSAL - NO,640013,0,0,14,14
PUSHMATAHA,STATE QUESTION NO. 794 LEGISLATIVE REFERENDUM NO. 371,FOR THE PROPOSAL - YES,640014,0,3,50,53
PUSHMATAHA,STATE QUESTION NO. 794 LEGISLATIVE REFERENDUM NO. 371,AGAINST THE PROPOSAL - NO,640014,0,0,21,21
PUSHMATAHA,STATE QUESTION NO. 794 LEGISLATIVE REFERENDUM NO. 371,FOR THE PROPOSAL - YES,640015,11,6,257,274
PUSHMATAHA,STATE QUESTION NO. 794 LEGISLATIVE REFERENDUM NO. 371,AGAINST THE PROPOSAL - NO,640015,5,2,84,91
PUSHMATAHA,STATE QUESTION NO. 794 LEGISLATIVE REFERENDUM NO. 371,FOR THE PROPOSAL - YES,640016,4,0,90,94
PUSHMATAHA,STATE QUESTION NO. 794 LEGISLATIVE REFERENDUM NO. 371,AGAINST THE PROPOSAL - NO,640016,2,0,26,28
PUSHMATAHA,STATE QUESTION NO. 794 LEGISLATIVE REFERENDUM NO. 371,FOR THE PROPOSAL - YES,640017,1,1,113,115
PUSHMATAHA,STATE QUESTION NO. 794 LEGISLATIVE REFERENDUM NO. 371,AGAINST THE PROPOSAL - NO,640017,1,0,45,46
ROGER MILLS,STATE QUESTION NO. 794 LEGISLATIVE REFERENDUM NO. 371,FOR THE PROPOSAL - YES,650101,4,12,90,106
ROGER MILLS,STATE QUESTION NO. 794 LEGISLATIVE REFERENDUM NO. 371,AGAINST THE PROPOSAL - NO,650101,0,1,28,29
ROGER MILLS,STATE QUESTION NO. 794 LEGISLATIVE REFERENDUM NO. 371,FOR THE PROPOSAL - YES,650102,3,15,68,86
ROGER MILLS,STATE QUESTION NO. 794 LEGISLATIVE REFERENDUM NO. 371,AGAINST THE PROPOSAL - NO,650102,2,3,35,40
ROGER MILLS,STATE QUESTION NO. 794 LEGISLATIVE REFERENDUM NO. 371,FOR THE PROPOSAL - YES,650103,1,25,107,133
ROGER MILLS,STATE QUESTION NO. 794 LEGISLATIVE REFERENDUM NO. 371,AGAINST THE PROPOSAL - NO,650103,3,11,55,69
ROGER MILLS,STATE QUESTION NO. 794 LEGISLATIVE REFERENDUM NO. 371,FOR THE PROPOSAL - YES,650201,8,7,238,253
ROGER MILLS,STATE QUESTION NO. 794 LEGISLATIVE REFERENDUM NO. 371,AGAINST THE PROPOSAL - NO,650201,0,5,79,84
ROGER MILLS,STATE QUESTION NO. 794 LEGISLATIVE REFERENDUM NO. 371,FOR THE PROPOSAL - YES,650202,3,20,33,56
ROGER MILLS,STATE QUESTION NO. 794 LEGISLATIVE REFERENDUM NO. 371,AGAINST THE PROPOSAL - NO,650202,1,7,26,34
ROGER MILLS,STATE QUESTION NO. 794 LEGISLATIVE REFERENDUM NO. 371,FOR THE PROPOSAL - YES,650203,2,5,42,49
ROGER MILLS,STATE QUESTION NO. 794 LEGISLATIVE REFERENDUM NO. 371,AGAINST THE PROPOSAL - NO,650203,2,1,28,31
ROGER MILLS,STATE QUESTION NO. 794 LEGISLATIVE REFERENDUM NO. 371,FOR THE PROPOSAL - YES,650301,3,7,85,95
ROGER MILLS,STATE QUESTION NO. 794 LEGISLATIVE REFERENDUM NO. 371,AGAINST THE PROPOSAL - NO,650301,0,1,39,40
ROGER MILLS,STATE QUESTION NO. 794 LEGISLATIVE REFERENDUM NO. 371,FOR THE PROPOSAL - YES,650302,6,13,91,110
ROGER MILLS,STATE QUESTION NO. 794 LEGISLATIVE REFERENDUM NO. 371,AGAINST THE PROPOSAL - NO,650302,5,5,45,55
ROGER MILLS,STATE QUESTION NO. 794 LEGISLATIVE REFERENDUM NO. 371,FOR THE PROPOSAL - YES,650303,6,30,99,135
ROGER MILLS,STATE QUESTION NO. 794 LEGISLATIVE REFERENDUM NO. 371,AGAINST THE PROPOSAL - NO,650303,4,10,60,74
ROGERS,STATE QUESTION NO. 794 LEGISLATIVE REFERENDUM NO. 371,FOR THE PROPOSAL - YES,660001,54,172,713,939
ROGERS,STATE QUESTION NO. 794 LEGISLATIVE REFERENDUM NO. 371,AGAINST THE PROPOSAL - NO,660001,13,33,196,242
ROGERS,STATE QUESTION NO. 794 LEGISLATIVE REFERENDUM NO. 371,FOR THE PROPOSAL - YES,660002,20,110,400,530
ROGERS,STATE QUESTION NO. 794 LEGISLATIVE REFERENDUM NO. 371,AGAINST THE PROPOSAL - NO,660002,3,36,85,124
ROGERS,STATE QUESTION NO. 794 LEGISLATIVE REFERENDUM NO. 371,FOR THE PROPOSAL - YES,660003,20,125,476,621
ROGERS,STATE QUESTION NO. 794 LEGISLATIVE REFERENDUM NO. 371,AGAINST THE PROPOSAL - NO,660003,6,19,152,177
ROGERS,STATE QUESTION NO. 794 LEGISLATIVE REFERENDUM NO. 371,FOR THE PROPOSAL - YES,660004,48,157,766,971
ROGERS,STATE QUESTION NO. 794 LEGISLATIVE REFERENDUM NO. 371,AGAINST THE PROPOSAL - NO,660004,14,42,182,238
ROGERS,STATE QUESTION NO. 794 LEGISLATIVE REFERENDUM NO. 371,FOR THE PROPOSAL - YES,660005,33,137,415,585
ROGERS,STATE QUESTION NO. 794 LEGISLATIVE REFERENDUM NO. 371,AGAINST THE PROPOSAL - NO,660005,5,33,94,132
ROGERS,STATE QUESTION NO. 794 LEGISLATIVE REFERENDUM NO. 371,FOR THE PROPOSAL - YES,660006,49,97,429,575
ROGERS,STATE QUESTION NO. 794 LEGISLATIVE REFERENDUM NO. 371,AGAINST THE PROPOSAL - NO,660006,7,17,113,137
ROGERS,STATE QUESTION NO. 794 LEGISLATIVE REFERENDUM NO. 371,FOR THE PROPOSAL - YES,660007,25,181,642,848
ROGERS,STATE QUESTION NO. 794 LEGISLATIVE REFERENDUM NO. 371,AGAINST THE PROPOSAL - NO,660007,14,41,193,248
ROGERS,STATE QUESTION NO. 794 LEGISLATIVE REFERENDUM NO. 371,FOR THE PROPOSAL - YES,660008,46,134,451,631
ROGERS,STATE QUESTION NO. 794 LEGISLATIVE REFERENDUM NO. 371,AGAINST THE PROPOSAL - NO,660008,12,32,112,156
ROGERS,STATE QUESTION NO. 794 LEGISLATIVE REFERENDUM NO. 371,FOR THE PROPOSAL - YES,660009,21,72,297,390
ROGERS,STATE QUESTION NO. 794 LEGISLATIVE REFERENDUM NO. 371,AGAINST THE PROPOSAL - NO,660009,9,19,98,126
ROGERS,STATE QUESTION NO. 794 LEGISLATIVE REFERENDUM NO. 371,FOR THE PROPOSAL - YES,660010,49,86,1083,1218
ROGERS,STATE QUESTION NO. 794 LEGISLATIVE REFERENDUM NO. 371,AGAINST THE PROPOSAL - NO,660010,9,18,243,270
ROGERS,STATE QUESTION NO. 794 LEGISLATIVE REFERENDUM NO. 371,FOR THE PROPOSAL - YES,660011,29,101,801,931
ROGERS,STATE QUESTION NO. 794 LEGISLATIVE REFERENDUM NO. 371,AGAINST THE PROPOSAL - NO,660011,9,19,224,252
ROGERS,STATE QUESTION NO. 794 LEGISLATIVE REFERENDUM NO. 371,FOR THE PROPOSAL - YES,660012,1,8,200,209
ROGERS,STATE QUESTION NO. 794 LEGISLATIVE REFERENDUM NO. 371,AGAINST THE PROPOSAL - NO,660012,4,1,61,66
ROGERS,STATE QUESTION NO. 794 LEGISLATIVE REFERENDUM NO. 371,FOR THE PROPOSAL - YES,660013,25,86,529,640
ROGERS,STATE QUESTION NO. 794 LEGISLATIVE REFERENDUM NO. 371,AGAINST THE PROPOSAL - NO,660013,3,21,145,169
ROGERS,STATE QUESTION NO. 794 LEGISLATIVE REFERENDUM NO. 371,FOR THE PROPOSAL - YES,660014,24,130,488,642
ROGERS,STATE QUESTION NO. 794 LEGISLATIVE REFERENDUM NO. 371,AGAINST THE PROPOSAL - NO,660014,1,28,141,170
ROGERS,STATE QUESTION NO. 794 LEGISLATIVE REFERENDUM NO. 371,FOR THE PROPOSAL - YES,660015,32,54,768,854
ROGERS,STATE QUESTION NO. 794 LEGISLATIVE REFERENDUM NO. 371,AGAINST THE PROPOSAL - NO,660015,13,10,189,212
ROGERS,STATE QUESTION NO. 794 LEGISLATIVE REFERENDUM NO. 371,FOR THE PROPOSAL - YES,660017,15,44,382,441
ROGERS,STATE QUESTION NO. 794 LEGISLATIVE REFERENDUM NO. 371,AGAINST THE PROPOSAL - NO,660017,1,17,109,127
ROGERS,STATE QUESTION NO. 794 LEGISLATIVE REFERENDUM NO. 371,FOR THE PROPOSAL - YES,660018,52,156,754,962
ROGERS,STATE QUESTION NO. 794 LEGISLATIVE REFERENDUM NO. 371,AGAINST THE PROPOSAL - NO,660018,11,46,165,222
ROGERS,STATE QUESTION NO. 794 LEGISLATIVE REFERENDUM NO. 371,FOR THE PROPOSAL - YES,660019,22,48,439,509
ROGERS,STATE QUESTION NO. 794 LEGISLATIVE REFERENDUM NO. 371,AGAINST THE PROPOSAL - NO,660019,12,18,126,156
ROGERS,STATE QUESTION NO. 794 LEGISLATIVE REFERENDUM NO. 371,FOR THE PROPOSAL - YES,660020,44,198,866,1108
ROGERS,STATE QUESTION NO. 794 LEGISLATIVE REFERENDUM NO. 371,AGAINST THE PROPOSAL - NO,660020,7,37,223,267
ROGERS,STATE QUESTION NO. 794 LEGISLATIVE REFERENDUM NO. 371,FOR THE PROPOSAL - YES,660021,14,33,252,299
ROGERS,STATE QUESTION NO. 794 LEGISLATIVE REFERENDUM NO. 371,AGAINST THE PROPOSAL - NO,660021,9,15,72,96
ROGERS,STATE QUESTION NO. 794 LEGISLATIVE REFERENDUM NO. 371,FOR THE PROPOSAL - YES,660022,21,123,663,807
ROGERS,STATE QUESTION NO. 794 LEGISLATIVE REFERENDUM NO. 371,AGAINST THE PROPOSAL - NO,660022,15,33,139,187
ROGERS,STATE QUESTION NO. 794 LEGISLATIVE REFERENDUM NO. 371,FOR THE PROPOSAL - YES,660023,36,71,1084,1191
ROGERS,STATE QUESTION NO. 794 LEGISLATIVE REFERENDUM NO. 371,AGAINST THE PROPOSAL - NO,660023,10,14,292,316
ROGERS,STATE QUESTION NO. 794 LEGISLATIVE REFERENDUM NO. 371,FOR THE PROPOSAL - YES,660024,13,14,366,393
ROGERS,STATE QUESTION NO. 794 LEGISLATIVE REFERENDUM NO. 371,AGAINST THE PROPOSAL - NO,660024,7,3,92,102
ROGERS,STATE QUESTION NO. 794 LEGISLATIVE REFERENDUM NO. 371,FOR THE PROPOSAL - YES,660025,8,2,169,179
ROGERS,STATE QUESTION NO. 794 LEGISLATIVE REFERENDUM NO. 371,AGAINST THE PROPOSAL - NO,660025,0,5,27,32
ROGERS,STATE QUESTION NO. 794 LEGISLATIVE REFERENDUM NO. 371,FOR THE PROPOSAL - YES,660026,44,95,989,1128
ROGERS,STATE QUESTION NO. 794 LEGISLATIVE REFERENDUM NO. 371,AGAINST THE PROPOSAL - NO,660026,5,11,267,283
ROGERS,STATE QUESTION NO. 794 LEGISLATIVE REFERENDUM NO. 371,FOR THE PROPOSAL - YES,660027,15,23,459,497
ROGERS,STATE QUESTION NO. 794 LEGISLATIVE REFERENDUM NO. 371,AGAINST THE PROPOSAL - NO,660027,0,9,117,126
ROGERS,STATE QUESTION NO. 794 LEGISLATIVE REFERENDUM NO. 371,FOR THE PROPOSAL - YES,660029,14,46,401,461
ROGERS,STATE QUESTION NO. 794 LEGISLATIVE REFERENDUM NO. 371,AGAINST THE PROPOSAL - NO,660029,4,9,101,114
ROGERS,STATE QUESTION NO. 794 LEGISLATIVE REFERENDUM NO. 371,FOR THE PROPOSAL - YES,660030,72,242,1065,1379
ROGERS,STATE QUESTION NO. 794 LEGISLATIVE REFERENDUM NO. 371,AGAINST THE PROPOSAL - NO,660030,26,58,321,405
ROGERS,STATE QUESTION NO. 794 LEGISLATIVE REFERENDUM NO. 371,FOR THE PROPOSAL - YES,660031,74,223,808,1105
ROGERS,STATE QUESTION NO. 794 LEGISLATIVE REFERENDUM NO. 371,AGAINST THE PROPOSAL - NO,660031,12,52,217,281
ROGERS,STATE QUESTION NO. 794 LEGISLATIVE REFERENDUM NO. 371,FOR THE PROPOSAL - YES,660032,46,99,390,535
ROGERS,STATE QUESTION NO. 794 LEGISLATIVE REFERENDUM NO. 371,AGAINST THE PROPOSAL - NO,660032,12,18,116,146
ROGERS,STATE QUESTION NO. 794 LEGISLATIVE REFERENDUM NO. 371,FOR THE PROPOSAL - YES,660033,8,14,274,296
ROGERS,STATE QUESTION NO. 794 LEGISLATIVE REFERENDUM NO. 371,AGAINST THE PROPOSAL - NO,660033,1,4,65,70
ROGERS,STATE QUESTION NO. 794 LEGISLATIVE REFERENDUM NO. 371,FOR THE PROPOSAL - YES,660110,29,83,571,683
ROGERS,STATE QUESTION NO. 794 LEGISLATIVE REFERENDUM NO. 371,AGAINST THE PROPOSAL - NO,660110,5,24,133,162
ROGERS,STATE QUESTION NO. 794 LEGISLATIVE REFERENDUM NO. 371,FOR THE PROPOSAL - YES,660116,13,35,472,520
ROGERS,STATE QUESTION NO. 794 LEGISLATIVE REFERENDUM NO. 371,AGAINST THE PROPOSAL - NO,660116,6,6,119,131
ROGERS,STATE QUESTION NO. 794 LEGISLATIVE REFERENDUM NO. 371,FOR THE PROPOSAL - YES,660120,32,92,580,704
ROGERS,STATE QUESTION NO. 794 LEGISLATIVE REFERENDUM NO. 371,AGAINST THE PROPOSAL - NO,660120,6,14,129,149
ROGERS,STATE QUESTION NO. 794 LEGISLATIVE REFERENDUM NO. 371,FOR THE PROPOSAL - YES,660128,16,27,490,533
ROGERS,STATE QUESTION NO. 794 LEGISLATIVE REFERENDUM NO. 371,AGAINST THE PROPOSAL - NO,660128,2,6,92,100
ROGERS,STATE QUESTION NO. 794 LEGISLATIVE REFERENDUM NO. 371,FOR THE PROPOSAL - YES,660130,114,453,1120,1687
ROGERS,STATE QUESTION NO. 794 LEGISLATIVE REFERENDUM NO. 371,AGAINST THE PROPOSAL - NO,660130,21,91,278,390
SEMINOLE,STATE QUESTION NO. 794 LEGISLATIVE REFERENDUM NO. 371,FOR THE PROPOSAL - YES,670010,20,32,539,591
SEMINOLE,STATE QUESTION NO. 794 LEGISLATIVE REFERENDUM NO. 371,AGAINST THE PROPOSAL - NO,670010,9,7,131,147
SEMINOLE,STATE QUESTION NO. 794 LEGISLATIVE REFERENDUM NO. 371,FOR THE PROPOSAL - YES,670012,5,1,73,79
SEMINOLE,STATE QUESTION NO. 794 LEGISLATIVE REFERENDUM NO. 371,AGAINST THE PROPOSAL - NO,670012,2,2,19,23
SEMINOLE,STATE QUESTION NO. 794 LEGISLATIVE REFERENDUM NO. 371,FOR THE PROPOSAL - YES,670014,25,14,514,553
SEMINOLE,STATE QUESTION NO. 794 LEGISLATIVE REFERENDUM NO. 371,AGAINST THE PROPOSAL - NO,670014,9,4,116,129
SEMINOLE,STATE QUESTION NO. 794 LEGISLATIVE REFERENDUM NO. 371,FOR THE PROPOSAL - YES,670015,12,21,229,262
SEMINOLE,STATE QUESTION NO. 794 LEGISLATIVE REFERENDUM NO. 371,AGAINST THE PROPOSAL - NO,670015,4,5,68,77
SEMINOLE,STATE QUESTION NO. 794 LEGISLATIVE REFERENDUM NO. 371,FOR THE PROPOSAL - YES,670020,13,14,459,486
SEMINOLE,STATE QUESTION NO. 794 LEGISLATIVE REFERENDUM NO. 371,AGAINST THE PROPOSAL - NO,670020,3,0,99,102
SEMINOLE,STATE QUESTION NO. 794 LEGISLATIVE REFERENDUM NO. 371,FOR THE PROPOSAL - YES,670022,27,20,446,493
SEMINOLE,STATE QUESTION NO. 794 LEGISLATIVE REFERENDUM NO. 371,AGAINST THE PROPOSAL - NO,670022,7,11,100,118
SEMINOLE,STATE QUESTION NO. 794 LEGISLATIVE REFERENDUM NO. 371,FOR THE PROPOSAL - YES,670023,28,49,540,617
SEMINOLE,STATE QUESTION NO. 794 LEGISLATIVE REFERENDUM NO. 371,AGAINST THE PROPOSAL - NO,670023,5,26,121,152
SEMINOLE,STATE QUESTION NO. 794 LEGISLATIVE REFERENDUM NO. 371,FOR THE PROPOSAL - YES,670024,13,16,377,406
SEMINOLE,STATE QUESTION NO. 794 LEGISLATIVE REFERENDUM NO. 371,AGAINST THE PROPOSAL - NO,670024,3,2,77,82
SEMINOLE,STATE QUESTION NO. 794 LEGISLATIVE REFERENDUM NO. 371,FOR THE PROPOSAL - YES,670025,7,6,96,109
SEMINOLE,STATE QUESTION NO. 794 LEGISLATIVE REFERENDUM NO. 371,AGAINST THE PROPOSAL - NO,670025,1,0,23,24
SEMINOLE,STATE QUESTION NO. 794 LEGISLATIVE REFERENDUM NO. 371,FOR THE PROPOSAL - YES,670030,2,7,141,150
SEMINOLE,STATE QUESTION NO. 794 LEGISLATIVE REFERENDUM NO. 371,AGAINST THE PROPOSAL - NO,670030,1,2,46,49
SEMINOLE,STATE QUESTION NO. 794 LEGISLATIVE REFERENDUM NO. 371,FOR THE PROPOSAL - YES,670032,17,64,323,404
SEMINOLE,STATE QUESTION NO. 794 LEGISLATIVE REFERENDUM NO. 371,AGAINST THE PROPOSAL - NO,670032,4,15,78,97
SEMINOLE,STATE QUESTION NO. 794 LEGISLATIVE REFERENDUM NO. 371,FOR THE PROPOSAL - YES,670033,3,8,43,54
SEMINOLE,STATE QUESTION NO. 794 LEGISLATIVE REFERENDUM NO. 371,AGAINST THE PROPOSAL - NO,670033,2,2,16,20
SEMINOLE,STATE QUESTION NO. 794 LEGISLATIVE REFERENDUM NO. 371,FOR THE PROPOSAL - YES,670034,33,102,536,671
SEMINOLE,STATE QUESTION NO. 794 LEGISLATIVE REFERENDUM NO. 371,AGAINST THE PROPOSAL - NO,670034,11,23,123,157
SEMINOLE,STATE QUESTION NO. 794 LEGISLATIVE REFERENDUM NO. 371,FOR THE PROPOSAL - YES,670035,21,20,275,316
SEMINOLE,STATE QUESTION NO. 794 LEGISLATIVE REFERENDUM NO. 371,AGAINST THE PROPOSAL - NO,670035,3,7,55,65
SEQUOYAH,STATE QUESTION NO. 794 LEGISLATIVE REFERENDUM NO. 371,FOR THE PROPOSAL - YES,680101,11,43,456,510
SEQUOYAH,STATE QUESTION NO. 794 LEGISLATIVE REFERENDUM NO. 371,AGAINST THE PROPOSAL - NO,680101,6,10,261,277
SEQUOYAH,STATE QUESTION NO. 794 LEGISLATIVE REFERENDUM NO. 371,FOR THE PROPOSAL - YES,680102,8,10,251,269
SEQUOYAH,STATE QUESTION NO. 794 LEGISLATIVE REFERENDUM NO. 371,AGAINST THE PROPOSAL - NO,680102,3,9,132,144
SEQUOYAH,STATE QUESTION NO. 794 LEGISLATIVE REFERENDUM NO. 371,FOR THE PROPOSAL - YES,680103,17,26,410,453
SEQUOYAH,STATE QUESTION NO. 794 LEGISLATIVE REFERENDUM NO. 371,AGAINST THE PROPOSAL - NO,680103,4,14,204,222
SEQUOYAH,STATE QUESTION NO. 794 LEGISLATIVE REFERENDUM NO. 371,FOR THE PROPOSAL - YES,680104,16,32,378,426
SEQUOYAH,STATE QUESTION NO. 794 LEGISLATIVE REFERENDUM NO. 371,AGAINST THE PROPOSAL - NO,680104,6,20,173,199
SEQUOYAH,STATE QUESTION NO. 794 LEGISLATIVE REFERENDUM NO. 371,FOR THE PROPOSAL - YES,680105,11,23,397,431
SEQUOYAH,STATE QUESTION NO. 794 LEGISLATIVE REFERENDUM NO. 371,AGAINST THE PROPOSAL - NO,680105,2,12,134,148
SEQUOYAH,STATE QUESTION NO. 794 LEGISLATIVE REFERENDUM NO. 371,FOR THE PROPOSAL - YES,680106,4,21,288,313
SEQUOYAH,STATE QUESTION NO. 794 LEGISLATIVE REFERENDUM NO. 371,AGAINST THE PROPOSAL - NO,680106,3,3,143,149
SEQUOYAH,STATE QUESTION NO. 794 LEGISLATIVE REFERENDUM NO. 371,FOR THE PROPOSAL - YES,680201,1,9,150,160
SEQUOYAH,STATE QUESTION NO. 794 LEGISLATIVE REFERENDUM NO. 371,AGAINST THE PROPOSAL - NO,680201,0,4,57,61
SEQUOYAH,STATE QUESTION NO. 794 LEGISLATIVE REFERENDUM NO. 371,FOR THE PROPOSAL - YES,680202,13,15,246,274
SEQUOYAH,STATE QUESTION NO. 794 LEGISLATIVE REFERENDUM NO. 371,AGAINST THE PROPOSAL - NO,680202,0,6,105,111
SEQUOYAH,STATE QUESTION NO. 794 LEGISLATIVE REFERENDUM NO. 371,FOR THE PROPOSAL - YES,680203,4,3,137,144
SEQUOYAH,STATE QUESTION NO. 794 LEGISLATIVE REFERENDUM NO. 371,AGAINST THE PROPOSAL - NO,680203,1,6,39,46
SEQUOYAH,STATE QUESTION NO. 794 LEGISLATIVE REFERENDUM NO. 371,FOR THE PROPOSAL - YES,680204,6,20,106,132
SEQUOYAH,STATE QUESTION NO. 794 LEGISLATIVE REFERENDUM NO. 371,AGAINST THE PROPOSAL - NO,680204,0,5,59,64
SEQUOYAH,STATE QUESTION NO. 794 LEGISLATIVE REFERENDUM NO. 371,FOR THE PROPOSAL - YES,680205,11,95,348,454
SEQUOYAH,STATE QUESTION NO. 794 LEGISLATIVE REFERENDUM NO. 371,AGAINST THE PROPOSAL - NO,680205,11,29,147,187
SEQUOYAH,STATE QUESTION NO. 794 LEGISLATIVE REFERENDUM NO. 371,FOR THE PROPOSAL - YES,680206,8,40,138,186
SEQUOYAH,STATE QUESTION NO. 794 LEGISLATIVE REFERENDUM NO. 371,AGAINST THE PROPOSAL - NO,680206,5,11,75,91
SEQUOYAH,STATE QUESTION NO. 794 LEGISLATIVE REFERENDUM NO. 371,FOR THE PROPOSAL - YES,680207,9,23,212,244
SEQUOYAH,STATE QUESTION NO. 794 LEGISLATIVE REFERENDUM NO. 371,AGAINST THE PROPOSAL - NO,680207,5,12,84,101
SEQUOYAH,STATE QUESTION NO. 794 LEGISLATIVE REFERENDUM NO. 371,FOR THE PROPOSAL - YES,680208,6,23,349,378
SEQUOYAH,STATE QUESTION NO. 794 LEGISLATIVE REFERENDUM NO. 371,AGAINST THE PROPOSAL - NO,680208,1,12,120,133
SEQUOYAH,STATE QUESTION NO. 794 LEGISLATIVE REFERENDUM NO. 371,FOR THE PROPOSAL - YES,680209,3,5,244,252
SEQUOYAH,STATE QUESTION NO. 794 LEGISLATIVE REFERENDUM NO. 371,AGAINST THE PROPOSAL - NO,680209,1,3,108,112
SEQUOYAH,STATE QUESTION NO. 794 LEGISLATIVE REFERENDUM NO. 371,FOR THE PROPOSAL - YES,680210,6,6,273,285
SEQUOYAH,STATE QUESTION NO. 794 LEGISLATIVE REFERENDUM NO. 371,AGAINST THE PROPOSAL - NO,680210,4,4,74,82
SEQUOYAH,STATE QUESTION NO. 794 LEGISLATIVE REFERENDUM NO. 371,FOR THE PROPOSAL - YES,680301,25,91,400,516
SEQUOYAH,STATE QUESTION NO. 794 LEGISLATIVE REFERENDUM NO. 371,AGAINST THE PROPOSAL - NO,680301,9,39,168,216
SEQUOYAH,STATE QUESTION NO. 794 LEGISLATIVE REFERENDUM NO. 371,FOR THE PROPOSAL - YES,680302,5,34,148,187
SEQUOYAH,STATE QUESTION NO. 794 LEGISLATIVE REFERENDUM NO. 371,AGAINST THE PROPOSAL - NO,680302,1,24,87,112
SEQUOYAH,STATE QUESTION NO. 794 LEGISLATIVE REFERENDUM NO. 371,FOR THE PROPOSAL - YES,680303,11,76,364,451
SEQUOYAH,STATE QUESTION NO. 794 LEGISLATIVE REFERENDUM NO. 371,AGAINST THE PROPOSAL - NO,680303,4,36,168,208
SEQUOYAH,STATE QUESTION NO. 794 LEGISLATIVE REFERENDUM NO. 371,FOR THE PROPOSAL - YES,680304,7,24,240,271
SEQUOYAH,STATE QUESTION NO. 794 LEGISLATIVE REFERENDUM NO. 371,AGAINST THE PROPOSAL - NO,680304,1,12,90,103
SEQUOYAH,STATE QUESTION NO. 794 LEGISLATIVE REFERENDUM NO. 371,FOR THE PROPOSAL - YES,680305,7,18,167,192
SEQUOYAH,STATE QUESTION NO. 794 LEGISLATIVE REFERENDUM NO. 371,AGAINST THE PROPOSAL - NO,680305,3,7,78,88
SEQUOYAH,STATE QUESTION NO. 794 LEGISLATIVE REFERENDUM NO. 371,FOR THE PROPOSAL - YES,680306,13,38,326,377
SEQUOYAH,STATE QUESTION NO. 794 LEGISLATIVE REFERENDUM NO. 371,AGAINST THE PROPOSAL - NO,680306,2,22,147,171
SEQUOYAH,STATE QUESTION NO. 794 LEGISLATIVE REFERENDUM NO. 371,FOR THE PROPOSAL - YES,680307,5,27,164,196
SEQUOYAH,STATE QUESTION NO. 794 LEGISLATIVE REFERENDUM NO. 371,AGAINST THE PROPOSAL - NO,680307,2,11,97,110
SEQUOYAH,STATE QUESTION NO. 794 LEGISLATIVE REFERENDUM NO. 371,FOR THE PROPOSAL - YES,680308,0,9,120,129
SEQUOYAH,STATE QUESTION NO. 794 LEGISLATIVE REFERENDUM NO. 371,AGAINST THE PROPOSAL - NO,680308,1,2,80,83
SEQUOYAH,STATE QUESTION NO. 794 LEGISLATIVE REFERENDUM NO. 371,FOR THE PROPOSAL - YES,680309,5,2,168,175
SEQUOYAH,STATE QUESTION NO. 794 LEGISLATIVE REFERENDUM NO. 371,AGAINST THE PROPOSAL - NO,680309,7,2,76,85
SEQUOYAH,STATE QUESTION NO. 794 LEGISLATIVE REFERENDUM NO. 371,FOR THE PROPOSAL - YES,680310,7,10,163,180
SEQUOYAH,STATE QUESTION NO. 794 LEGISLATIVE REFERENDUM NO. 371,AGAINST THE PROPOSAL - NO,680310,2,6,111,119
STEPHENS,STATE QUESTION NO. 794 LEGISLATIVE REFERENDUM NO. 371,FOR THE PROPOSAL - YES,690001,14,59,518,591
STEPHENS,STATE QUESTION NO. 794 LEGISLATIVE REFERENDUM NO. 371,AGAINST THE PROPOSAL - NO,690001,6,23,122,151
STEPHENS,STATE QUESTION NO. 794 LEGISLATIVE REFERENDUM NO. 371,FOR THE PROPOSAL - YES,690003,22,45,409,476
STEPHENS,STATE QUESTION NO. 794 LEGISLATIVE REFERENDUM NO. 371,AGAINST THE PROPOSAL - NO,690003,5,10,118,133
STEPHENS,STATE QUESTION NO. 794 LEGISLATIVE REFERENDUM NO. 371,FOR THE PROPOSAL - YES,690004,20,38,486,544
STEPHENS,STATE QUESTION NO. 794 LEGISLATIVE REFERENDUM NO. 371,AGAINST THE PROPOSAL - NO,690004,2,12,110,124
STEPHENS,STATE QUESTION NO. 794 LEGISLATIVE REFERENDUM NO. 371,FOR THE PROPOSAL - YES,690008,7,29,371,407
STEPHENS,STATE QUESTION NO. 794 LEGISLATIVE REFERENDUM NO. 371,AGAINST THE PROPOSAL - NO,690008,0,9,96,105
STEPHENS,STATE QUESTION NO. 794 LEGISLATIVE REFERENDUM NO. 371,FOR THE PROPOSAL - YES,690012,14,52,372,438
STEPHENS,STATE QUESTION NO. 794 LEGISLATIVE REFERENDUM NO. 371,AGAINST THE PROPOSAL - NO,690012,4,12,85,101
STEPHENS,STATE QUESTION NO. 794 LEGISLATIVE REFERENDUM NO. 371,FOR THE PROPOSAL - YES,690013,9,6,129,144
STEPHENS,STATE QUESTION NO. 794 LEGISLATIVE REFERENDUM NO. 371,AGAINST THE PROPOSAL - NO,690013,4,4,27,35
STEPHENS,STATE QUESTION NO. 794 LEGISLATIVE REFERENDUM NO. 371,FOR THE PROPOSAL - YES,690014,35,74,678,787
STEPHENS,STATE QUESTION NO. 794 LEGISLATIVE REFERENDUM NO. 371,AGAINST THE PROPOSAL - NO,690014,9,12,148,169
STEPHENS,STATE QUESTION NO. 794 LEGISLATIVE REFERENDUM NO. 371,FOR THE PROPOSAL - YES,690015,4,7,123,134
STEPHENS,STATE QUESTION NO. 794 LEGISLATIVE REFERENDUM NO. 371,AGAINST THE PROPOSAL - NO,690015,0,2,25,27
STEPHENS,STATE QUESTION NO. 794 LEGISLATIVE REFERENDUM NO. 371,FOR THE PROPOSAL - YES,690016,33,86,715,834
STEPHENS,STATE QUESTION NO. 794 LEGISLATIVE REFERENDUM NO. 371,AGAINST THE PROPOSAL - NO,690016,16,23,168,207
STEPHENS,STATE QUESTION NO. 794 LEGISLATIVE REFERENDUM NO. 371,FOR THE PROPOSAL - YES,690019,28,96,717,841
STEPHENS,STATE QUESTION NO. 794 LEGISLATIVE REFERENDUM NO. 371,AGAINST THE PROPOSAL - NO,690019,4,16,160,180
STEPHENS,STATE QUESTION NO. 794 LEGISLATIVE REFERENDUM NO. 371,FOR THE PROPOSAL - YES,690032,15,28,612,655
STEPHENS,STATE QUESTION NO. 794 LEGISLATIVE REFERENDUM NO. 371,AGAINST THE PROPOSAL - NO,690032,5,11,138,154
STEPHENS,STATE QUESTION NO. 794 LEGISLATIVE REFERENDUM NO. 371,FOR THE PROPOSAL - YES,690033,41,79,755,875
STEPHENS,STATE QUESTION NO. 794 LEGISLATIVE REFERENDUM NO. 371,AGAINST THE PROPOSAL - NO,690033,14,10,157,181
STEPHENS,STATE QUESTION NO. 794 LEGISLATIVE REFERENDUM NO. 371,FOR THE PROPOSAL - YES,690041,13,20,455,488
STEPHENS,STATE QUESTION NO. 794 LEGISLATIVE REFERENDUM NO. 371,AGAINST THE PROPOSAL - NO,690041,3,7,109,119
STEPHENS,STATE QUESTION NO. 794 LEGISLATIVE REFERENDUM NO. 371,FOR THE PROPOSAL - YES,690049,1,3,95,99
STEPHENS,STATE QUESTION NO. 794 LEGISLATIVE REFERENDUM NO. 371,AGAINST THE PROPOSAL - NO,690049,2,0,20,22
STEPHENS,STATE QUESTION NO. 794 LEGISLATIVE REFERENDUM NO. 371,FOR THE PROPOSAL - YES,690050,28,100,675,803
STEPHENS,STATE QUESTION NO. 794 LEGISLATIVE REFERENDUM NO. 371,AGAINST THE PROPOSAL - NO,690050,4,16,143,163
STEPHENS,STATE QUESTION NO. 794 LEGISLATIVE REFERENDUM NO. 371,FOR THE PROPOSAL - YES,690051,3,14,241,258
STEPHENS,STATE QUESTION NO. 794 LEGISLATIVE REFERENDUM NO. 371,AGAINST THE PROPOSAL - NO,690051,0,8,45,53
STEPHENS,STATE QUESTION NO. 794 LEGISLATIVE REFERENDUM NO. 371,FOR THE PROPOSAL - YES,690052,6,11,110,127
STEPHENS,STATE QUESTION NO. 794 LEGISLATIVE REFERENDUM NO. 371,AGAINST THE PROPOSAL - NO,690052,1,4,25,30
STEPHENS,STATE QUESTION NO. 794 LEGISLATIVE REFERENDUM NO. 371,FOR THE PROPOSAL - YES,690053,0,10,124,134
STEPHENS,STATE QUESTION NO. 794 LEGISLATIVE REFERENDUM NO. 371,AGAINST THE PROPOSAL - NO,690053,1,3,30,34
STEPHENS,STATE QUESTION NO. 794 LEGISLATIVE REFERENDUM NO. 371,FOR THE PROPOSAL - YES,690054,5,12,165,182
STEPHENS,STATE QUESTION NO. 794 LEGISLATIVE REFERENDUM NO. 371,AGAINST THE PROPOSAL - NO,690054,2,0,39,41
STEPHENS,STATE QUESTION NO. 794 LEGISLATIVE REFERENDUM NO. 371,FOR THE PROPOSAL - YES,690055,5,10,135,150
STEPHENS,STATE QUESTION NO. 794 LEGISLATIVE REFERENDUM NO. 371,AGAINST THE PROPOSAL - NO,690055,0,0,42,42
STEPHENS,STATE QUESTION NO. 794 LEGISLATIVE REFERENDUM NO. 371,FOR THE PROPOSAL - YES,690056,4,11,204,219
STEPHENS,STATE QUESTION NO. 794 LEGISLATIVE REFERENDUM NO. 371,AGAINST THE PROPOSAL - NO,690056,2,0,58,60
STEPHENS,STATE QUESTION NO. 794 LEGISLATIVE REFERENDUM NO. 371,FOR THE PROPOSAL - YES,690057,9,52,379,440
STEPHENS,STATE QUESTION NO. 794 LEGISLATIVE REFERENDUM NO. 371,AGAINST THE PROPOSAL - NO,690057,1,8,63,72
STEPHENS,STATE QUESTION NO. 794 LEGISLATIVE REFERENDUM NO. 371,FOR THE PROPOSAL - YES,690058,2,2,208,212
STEPHENS,STATE QUESTION NO. 794 LEGISLATIVE REFERENDUM NO. 371,AGAINST THE PROPOSAL - NO,690058,0,0,63,63
STEPHENS,STATE QUESTION NO. 794 LEGISLATIVE REFERENDUM NO. 371,FOR THE PROPOSAL - YES,690059,4,11,144,159
STEPHENS,STATE QUESTION NO. 794 LEGISLATIVE REFERENDUM NO. 371,AGAINST THE PROPOSAL - NO,690059,0,5,36,41
STEPHENS,STATE QUESTION NO. 794 LEGISLATIVE REFERENDUM NO. 371,FOR THE PROPOSAL - YES,690060,1,4,16,21
STEPHENS,STATE QUESTION NO. 794 LEGISLATIVE REFERENDUM NO. 371,AGAINST THE PROPOSAL - NO,690060,0,1,4,5
STEPHENS,STATE QUESTION NO. 794 LEGISLATIVE REFERENDUM NO. 371,FOR THE PROPOSAL - YES,690061,6,33,398,437
STEPHENS,STATE QUESTION NO. 794 LEGISLATIVE REFERENDUM NO. 371,AGAINST THE PROPOSAL - NO,690061,3,4,79,86
STEPHENS,STATE QUESTION NO. 794 LEGISLATIVE REFERENDUM NO. 371,FOR THE PROPOSAL - YES,690062,12,15,352,379
STEPHENS,STATE QUESTION NO. 794 LEGISLATIVE REFERENDUM NO. 371,AGAINST THE PROPOSAL - NO,690062,2,5,49,56
STEPHENS,STATE QUESTION NO. 794 LEGISLATIVE REFERENDUM NO. 371,FOR THE PROPOSAL - YES,690063,7,16,203,226
STEPHENS,STATE QUESTION NO. 794 LEGISLATIVE REFERENDUM NO. 371,AGAINST THE PROPOSAL - NO,690063,0,2,42,44
TEXAS,STATE QUESTION NO. 794 LEGISLATIVE REFERENDUM NO. 371,FOR THE PROPOSAL - YES,700101,23,12,369,404
TEXAS,STATE QUESTION NO. 794 LEGISLATIVE REFERENDUM NO. 371,AGAINST THE PROPOSAL - NO,700101,8,5,150,163
TEXAS,STATE QUESTION NO. 794 LEGISLATIVE REFERENDUM NO. 371,FOR THE PROPOSAL - YES,700102,5,12,161,178
TEXAS,STATE QUESTION NO. 794 LEGISLATIVE REFERENDUM NO. 371,AGAINST THE PROPOSAL - NO,700102,1,9,54,64
TEXAS,STATE QUESTION NO. 794 LEGISLATIVE REFERENDUM NO. 371,FOR THE PROPOSAL - YES,700104,16,2,214,232
TEXAS,STATE QUESTION NO. 794 LEGISLATIVE REFERENDUM NO. 371,AGAINST THE PROPOSAL - NO,700104,2,4,67,73
TEXAS,STATE QUESTION NO. 794 LEGISLATIVE REFERENDUM NO. 371,FOR THE PROPOSAL - YES,700107,2,6,70,78
TEXAS,STATE QUESTION NO. 794 LEGISLATIVE REFERENDUM NO. 371,AGAINST THE PROPOSAL - NO,700107,4,3,44,51
TEXAS,STATE QUESTION NO. 794 LEGISLATIVE REFERENDUM NO. 371,FOR THE PROPOSAL - YES,700201,20,80,386,486
TEXAS,STATE QUESTION NO. 794 LEGISLATIVE REFERENDUM NO. 371,AGAINST THE PROPOSAL - NO,700201,2,31,122,155
TEXAS,STATE QUESTION NO. 794 LEGISLATIVE REFERENDUM NO. 371,FOR THE PROPOSAL - YES,700202,12,29,146,187
TEXAS,STATE QUESTION NO. 794 LEGISLATIVE REFERENDUM NO. 371,AGAINST THE PROPOSAL - NO,700202,6,15,45,66
TEXAS,STATE QUESTION NO. 794 LEGISLATIVE REFERENDUM NO. 371,FOR THE PROPOSAL - YES,700205,19,92,346,457
TEXAS,STATE QUESTION NO. 794 LEGISLATIVE REFERENDUM NO. 371,AGAINST THE PROPOSAL - NO,700205,3,31,122,156
TEXAS,STATE QUESTION NO. 794 LEGISLATIVE REFERENDUM NO. 371,FOR THE PROPOSAL - YES,700302,8,13,75,96
TEXAS,STATE QUESTION NO. 794 LEGISLATIVE REFERENDUM NO. 371,AGAINST THE PROPOSAL - NO,700302,0,6,21,27
TEXAS,STATE QUESTION NO. 794 LEGISLATIVE REFERENDUM NO. 371,FOR THE PROPOSAL - YES,700303,6,10,170,186
TEXAS,STATE QUESTION NO. 794 LEGISLATIVE REFERENDUM NO. 371,AGAINST THE PROPOSAL - NO,700303,6,6,69,81
TEXAS,STATE QUESTION NO. 794 LEGISLATIVE REFERENDUM NO. 371,FOR THE PROPOSAL - YES,700304,8,10,205,223
TEXAS,STATE QUESTION NO. 794 LEGISLATIVE REFERENDUM NO. 371,AGAINST THE PROPOSAL - NO,700304,0,6,61,67
TEXAS,STATE QUESTION NO. 794 LEGISLATIVE REFERENDUM NO. 371,FOR THE PROPOSAL - YES,700305,11,63,444,518
TEXAS,STATE QUESTION NO. 794 LEGISLATIVE REFERENDUM NO. 371,AGAINST THE PROPOSAL - NO,700305,7,20,124,151
TILLMAN,STATE QUESTION NO. 794 LEGISLATIVE REFERENDUM NO. 371,FOR THE PROPOSAL - YES,710001,13,69,250,332
TILLMAN,STATE QUESTION NO. 794 LEGISLATIVE REFERENDUM NO. 371,AGAINST THE PROPOSAL - NO,710001,6,24,103,133
TILLMAN,STATE QUESTION NO. 794 LEGISLATIVE REFERENDUM NO. 371,FOR THE PROPOSAL - YES,710002,1,26,162,189
TILLMAN,STATE QUESTION NO. 794 LEGISLATIVE REFERENDUM NO. 371,AGAINST THE PROPOSAL - NO,710002,5,10,41,56
TILLMAN,STATE QUESTION NO. 794 LEGISLATIVE REFERENDUM NO. 371,FOR THE PROPOSAL - YES,710003,2,17,70,89
TILLMAN,STATE QUESTION NO. 794 LEGISLATIVE REFERENDUM NO. 371,AGAINST THE PROPOSAL - NO,710003,0,4,26,30
TILLMAN,STATE QUESTION NO. 794 LEGISLATIVE REFERENDUM NO. 371,FOR THE PROPOSAL - YES,710004,1,25,109,135
TILLMAN,STATE QUESTION NO. 794 LEGISLATIVE REFERENDUM NO. 371,AGAINST THE PROPOSAL - NO,710004,0,9,29,38
TILLMAN,STATE QUESTION NO. 794 LEGISLATIVE REFERENDUM NO. 371,FOR THE PROPOSAL - YES,710006,6,7,67,80
TILLMAN,STATE QUESTION NO. 794 LEGISLATIVE REFERENDUM NO. 371,AGAINST THE PROPOSAL - NO,710006,2,5,30,37
TILLMAN,STATE QUESTION NO. 794 LEGISLATIVE REFERENDUM NO. 371,FOR THE PROPOSAL - YES,710007,1,8,210,219
TILLMAN,STATE QUESTION NO. 794 LEGISLATIVE REFERENDUM NO. 371,AGAINST THE PROPOSAL - NO,710007,0,0,62,62
TILLMAN,STATE QUESTION NO. 794 LEGISLATIVE REFERENDUM NO. 371,FOR THE PROPOSAL - YES,710009,2,10,92,104
TILLMAN,STATE QUESTION NO. 794 LEGISLATIVE REFERENDUM NO. 371,AGAINST THE PROPOSAL - NO,710009,2,5,31,38
TILLMAN,STATE QUESTION NO. 794 LEGISLATIVE REFERENDUM NO. 371,FOR THE PROPOSAL - YES,710010,10,11,265,286
TILLMAN,STATE QUESTION NO. 794 LEGISLATIVE REFERENDUM NO. 371,AGAINST THE PROPOSAL - NO,710010,1,7,91,99
TILLMAN,STATE QUESTION NO. 794 LEGISLATIVE REFERENDUM NO. 371,FOR THE PROPOSAL - YES,710012,1,13,58,72
TILLMAN,STATE QUESTION NO. 794 LEGISLATIVE REFERENDUM NO. 371,AGAINST THE PROPOSAL - NO,710012,0,7,21,28
TULSA,STATE QUESTION NO. 794 LEGISLATIVE REFERENDUM NO. 371,FOR THE PROPOSAL - YES,720001,0,0,498,498
TULSA,STATE QUESTION NO. 794 LEGISLATIVE REFERENDUM NO. 371,AGAINST THE PROPOSAL - NO,720001,0,0,134,134
TULSA,STATE QUESTION NO. 794 LEGISLATIVE REFERENDUM NO. 371,FOR THE PROPOSAL - YES,720002,0,0,477,477
TULSA,STATE QUESTION NO. 794 LEGISLATIVE REFERENDUM NO. 371,AGAINST THE PROPOSAL - NO,720002,0,0,113,113
TULSA,STATE QUESTION NO. 794 LEGISLATIVE REFERENDUM NO. 371,FOR THE PROPOSAL - YES,720003,0,0,207,207
TULSA,STATE QUESTION NO. 794 LEGISLATIVE REFERENDUM NO. 371,AGAINST THE PROPOSAL - NO,720003,0,0,56,56
TULSA,STATE QUESTION NO. 794 LEGISLATIVE REFERENDUM NO. 371,FOR THE PROPOSAL - YES,720004,0,0,570,570
TULSA,STATE QUESTION NO. 794 LEGISLATIVE REFERENDUM NO. 371,AGAINST THE PROPOSAL - NO,720004,0,0,159,159
TULSA,STATE QUESTION NO. 794 LEGISLATIVE REFERENDUM NO. 371,FOR THE PROPOSAL - YES,720005,0,0,258,258
TULSA,STATE QUESTION NO. 794 LEGISLATIVE REFERENDUM NO. 371,AGAINST THE PROPOSAL - NO,720005,0,0,76,76
TULSA,STATE QUESTION NO. 794 LEGISLATIVE REFERENDUM NO. 371,FOR THE PROPOSAL - YES,720006,0,0,610,610
TULSA,STATE QUESTION NO. 794 LEGISLATIVE REFERENDUM NO. 371,AGAINST THE PROPOSAL - NO,720006,0,0,157,157
TULSA,STATE QUESTION NO. 794 LEGISLATIVE REFERENDUM NO. 371,FOR THE PROPOSAL - YES,720007,0,0,255,255
TULSA,STATE QUESTION NO. 794 LEGISLATIVE REFERENDUM NO. 371,AGAINST THE PROPOSAL - NO,720007,0,0,80,80
TULSA,STATE QUESTION NO. 794 LEGISLATIVE REFERENDUM NO. 371,FOR THE PROPOSAL - YES,720008,0,0,340,340
TULSA,STATE QUESTION NO. 794 LEGISLATIVE REFERENDUM NO. 371,AGAINST THE PROPOSAL - NO,720008,0,0,75,75
TULSA,STATE QUESTION NO. 794 LEGISLATIVE REFERENDUM NO. 371,FOR THE PROPOSAL - YES,720009,0,0,108,108
TULSA,STATE QUESTION NO. 794 LEGISLATIVE REFERENDUM NO. 371,AGAINST THE PROPOSAL - NO,720009,0,0,25,25
TULSA,STATE QUESTION NO. 794 LEGISLATIVE REFERENDUM NO. 371,FOR THE PROPOSAL - YES,720010,0,0,335,335
TULSA,STATE QUESTION NO. 794 LEGISLATIVE REFERENDUM NO. 371,AGAINST THE PROPOSAL - NO,720010,0,0,88,88
TULSA,STATE QUESTION NO. 794 LEGISLATIVE REFERENDUM NO. 371,FOR THE PROPOSAL - YES,720011,0,0,300,300
TULSA,STATE QUESTION NO. 794 LEGISLATIVE REFERENDUM NO. 371,AGAINST THE PROPOSAL - NO,720011,0,0,74,74
TULSA,STATE QUESTION NO. 794 LEGISLATIVE REFERENDUM NO. 371,FOR THE PROPOSAL - YES,720012,0,0,244,244
TULSA,STATE QUESTION NO. 794 LEGISLATIVE REFERENDUM NO. 371,AGAINST THE PROPOSAL - NO,720012,0,0,64,64
TULSA,STATE QUESTION NO. 794 LEGISLATIVE REFERENDUM NO. 371,FOR THE PROPOSAL - YES,720013,0,0,599,599
TULSA,STATE QUESTION NO. 794 LEGISLATIVE REFERENDUM NO. 371,AGAINST THE PROPOSAL - NO,720013,0,0,164,164
TULSA,STATE QUESTION NO. 794 LEGISLATIVE REFERENDUM NO. 371,FOR THE PROPOSAL - YES,720014,0,0,460,460
TULSA,STATE QUESTION NO. 794 LEGISLATIVE REFERENDUM NO. 371,AGAINST THE PROPOSAL - NO,720014,0,0,166,166
TULSA,STATE QUESTION NO. 794 LEGISLATIVE REFERENDUM NO. 371,FOR THE PROPOSAL - YES,720015,0,0,252,252
TULSA,STATE QUESTION NO. 794 LEGISLATIVE REFERENDUM NO. 371,AGAINST THE PROPOSAL - NO,720015,0,0,78,78
TULSA,STATE QUESTION NO. 794 LEGISLATIVE REFERENDUM NO. 371,FOR THE PROPOSAL - YES,720016,0,0,104,104
TULSA,STATE QUESTION NO. 794 LEGISLATIVE REFERENDUM NO. 371,AGAINST THE PROPOSAL - NO,720016,0,0,33,33
TULSA,STATE QUESTION NO. 794 LEGISLATIVE REFERENDUM NO. 371,FOR THE PROPOSAL - YES,720017,0,0,190,190
TULSA,STATE QUESTION NO. 794 LEGISLATIVE REFERENDUM NO. 371,AGAINST THE PROPOSAL - NO,720017,0,0,55,55
TULSA,STATE QUESTION NO. 794 LEGISLATIVE REFERENDUM NO. 371,FOR THE PROPOSAL - YES,720018,0,0,242,242
TULSA,STATE QUESTION NO. 794 LEGISLATIVE REFERENDUM NO. 371,AGAINST THE PROPOSAL - NO,720018,0,0,56,56
TULSA,STATE QUESTION NO. 794 LEGISLATIVE REFERENDUM NO. 371,FOR THE PROPOSAL - YES,720019,0,0,260,260
TULSA,STATE QUESTION NO. 794 LEGISLATIVE REFERENDUM NO. 371,AGAINST THE PROPOSAL - NO,720019,0,0,70,70
TULSA,STATE QUESTION NO. 794 LEGISLATIVE REFERENDUM NO. 371,FOR THE PROPOSAL - YES,720020,0,0,240,240
TULSA,STATE QUESTION NO. 794 LEGISLATIVE REFERENDUM NO. 371,AGAINST THE PROPOSAL - NO,720020,0,0,84,84
TULSA,STATE QUESTION NO. 794 LEGISLATIVE REFERENDUM NO. 371,FOR THE PROPOSAL - YES,720021,0,0,34,34
TULSA,STATE QUESTION NO. 794 LEGISLATIVE REFERENDUM NO. 371,AGAINST THE PROPOSAL - NO,720021,0,0,5,5
TULSA,STATE QUESTION NO. 794 LEGISLATIVE REFERENDUM NO. 371,FOR THE PROPOSAL - YES,720022,0,0,339,339
TULSA,STATE QUESTION NO. 794 LEGISLATIVE REFERENDUM NO. 371,AGAINST THE PROPOSAL - NO,720022,0,0,67,67
TULSA,STATE QUESTION NO. 794 LEGISLATIVE REFERENDUM NO. 371,FOR THE PROPOSAL - YES,720023,0,0,164,164
TULSA,STATE QUESTION NO. 794 LEGISLATIVE REFERENDUM NO. 371,AGAINST THE PROPOSAL - NO,720023,0,0,38,38
TULSA,STATE QUESTION NO. 794 LEGISLATIVE REFERENDUM NO. 371,FOR THE PROPOSAL - YES,720024,0,0,262,262
TULSA,STATE QUESTION NO. 794 LEGISLATIVE REFERENDUM NO. 371,AGAINST THE PROPOSAL - NO,720024,0,0,89,89
TULSA,STATE QUESTION NO. 794 LEGISLATIVE REFERENDUM NO. 371,FOR THE PROPOSAL - YES,720025,0,0,207,207
TULSA,STATE QUESTION NO. 794 LEGISLATIVE REFERENDUM NO. 371,AGAINST THE PROPOSAL - NO,720025,0,0,49,49
TULSA,STATE QUESTION NO. 794 LEGISLATIVE REFERENDUM NO. 371,FOR THE PROPOSAL - YES,720026,0,0,277,277
TULSA,STATE QUESTION NO. 794 LEGISLATIVE REFERENDUM NO. 371,AGAINST THE PROPOSAL - NO,720026,0,0,49,49
TULSA,STATE QUESTION NO. 794 LEGISLATIVE REFERENDUM NO. 371,FOR THE PROPOSAL - YES,720027,0,0,224,224
TULSA,STATE QUESTION NO. 794 LEGISLATIVE REFERENDUM NO. 371,AGAINST THE PROPOSAL - NO,720027,0,0,51,51
TULSA,STATE QUESTION NO. 794 LEGISLATIVE REFERENDUM NO. 371,FOR THE PROPOSAL - YES,720028,0,0,343,343
TULSA,STATE QUESTION NO. 794 LEGISLATIVE REFERENDUM NO. 371,AGAINST THE PROPOSAL - NO,720028,0,0,79,79
TULSA,STATE QUESTION NO. 794 LEGISLATIVE REFERENDUM NO. 371,FOR THE PROPOSAL - YES,720029,0,0,250,250
TULSA,STATE QUESTION NO. 794 LEGISLATIVE REFERENDUM NO. 371,AGAINST THE PROPOSAL - NO,720029,0,0,61,61
TULSA,STATE QUESTION NO. 794 LEGISLATIVE REFERENDUM NO. 371,FOR THE PROPOSAL - YES,720030,0,0,409,409
TULSA,STATE QUESTION NO. 794 LEGISLATIVE REFERENDUM NO. 371,AGAINST THE PROPOSAL - NO,720030,0,0,240,240
TULSA,STATE QUESTION NO. 794 LEGISLATIVE REFERENDUM NO. 371,FOR THE PROPOSAL - YES,720031,0,0,166,166
TULSA,STATE QUESTION NO. 794 LEGISLATIVE REFERENDUM NO. 371,AGAINST THE PROPOSAL - NO,720031,0,0,59,59
TULSA,STATE QUESTION NO. 794 LEGISLATIVE REFERENDUM NO. 371,FOR THE PROPOSAL - YES,720032,0,0,247,247
TULSA,STATE QUESTION NO. 794 LEGISLATIVE REFERENDUM NO. 371,AGAINST THE PROPOSAL - NO,720032,0,0,124,124
TULSA,STATE QUESTION NO. 794 LEGISLATIVE REFERENDUM NO. 371,FOR THE PROPOSAL - YES,720033,0,0,227,227
TULSA,STATE QUESTION NO. 794 LEGISLATIVE REFERENDUM NO. 371,AGAINST THE PROPOSAL - NO,720033,0,0,109,109
TULSA,STATE QUESTION NO. 794 LEGISLATIVE REFERENDUM NO. 371,FOR THE PROPOSAL - YES,720034,0,0,181,181
TULSA,STATE QUESTION NO. 794 LEGISLATIVE REFERENDUM NO. 371,AGAINST THE PROPOSAL - NO,720034,0,0,79,79
TULSA,STATE QUESTION NO. 794 LEGISLATIVE REFERENDUM NO. 371,FOR THE PROPOSAL - YES,720035,0,0,611,611
TULSA,STATE QUESTION NO. 794 LEGISLATIVE REFERENDUM NO. 371,AGAINST THE PROPOSAL - NO,720035,0,0,292,292
TULSA,STATE QUESTION NO. 794 LEGISLATIVE REFERENDUM NO. 371,FOR THE PROPOSAL - YES,720036,0,0,556,556
TULSA,STATE QUESTION NO. 794 LEGISLATIVE REFERENDUM NO. 371,AGAINST THE PROPOSAL - NO,720036,0,0,236,236
TULSA,STATE QUESTION NO. 794 LEGISLATIVE REFERENDUM NO. 371,FOR THE PROPOSAL - YES,720037,0,0,128,128
TULSA,STATE QUESTION NO. 794 LEGISLATIVE REFERENDUM NO. 371,AGAINST THE PROPOSAL - NO,720037,0,0,77,77
TULSA,STATE QUESTION NO. 794 LEGISLATIVE REFERENDUM NO. 371,FOR THE PROPOSAL - YES,720038,0,0,264,264
TULSA,STATE QUESTION NO. 794 LEGISLATIVE REFERENDUM NO. 371,AGAINST THE PROPOSAL - NO,720038,0,0,80,80
TULSA,STATE QUESTION NO. 794 LEGISLATIVE REFERENDUM NO. 371,FOR THE PROPOSAL - YES,720039,0,0,413,413
TULSA,STATE QUESTION NO. 794 LEGISLATIVE REFERENDUM NO. 371,AGAINST THE PROPOSAL - NO,720039,0,0,121,121
TULSA,STATE QUESTION NO. 794 LEGISLATIVE REFERENDUM NO. 371,FOR THE PROPOSAL - YES,720040,0,0,153,153
TULSA,STATE QUESTION NO. 794 LEGISLATIVE REFERENDUM NO. 371,AGAINST THE PROPOSAL - NO,720040,0,0,35,35
TULSA,STATE QUESTION NO. 794 LEGISLATIVE REFERENDUM NO. 371,FOR THE PROPOSAL - YES,720041,0,0,233,233
TULSA,STATE QUESTION NO. 794 LEGISLATIVE REFERENDUM NO. 371,AGAINST THE PROPOSAL - NO,720041,0,0,49,49
TULSA,STATE QUESTION NO. 794 LEGISLATIVE REFERENDUM NO. 371,FOR THE PROPOSAL - YES,720042,0,0,279,279
TULSA,STATE QUESTION NO. 794 LEGISLATIVE REFERENDUM NO. 371,AGAINST THE PROPOSAL - NO,720042,0,0,46,46
TULSA,STATE QUESTION NO. 794 LEGISLATIVE REFERENDUM NO. 371,FOR THE PROPOSAL - YES,720043,0,0,291,291
TULSA,STATE QUESTION NO. 794 LEGISLATIVE REFERENDUM NO. 371,AGAINST THE PROPOSAL - NO,720043,0,0,81,81
TULSA,STATE QUESTION NO. 794 LEGISLATIVE REFERENDUM NO. 371,FOR THE PROPOSAL - YES,720044,0,0,459,459
TULSA,STATE QUESTION NO. 794 LEGISLATIVE REFERENDUM NO. 371,AGAINST THE PROPOSAL - NO,720044,0,0,100,100
TULSA,STATE QUESTION NO. 794 LEGISLATIVE REFERENDUM NO. 371,FOR THE PROPOSAL - YES,720045,0,0,6,6
TULSA,STATE QUESTION NO. 794 LEGISLATIVE REFERENDUM NO. 371,AGAINST THE PROPOSAL - NO,720045,0,0,1,1
TULSA,STATE QUESTION NO. 794 LEGISLATIVE REFERENDUM NO. 371,FOR THE PROPOSAL - YES,720046,0,0,692,692
TULSA,STATE QUESTION NO. 794 LEGISLATIVE REFERENDUM NO. 371,AGAINST THE PROPOSAL - NO,720046,0,0,397,397
TULSA,STATE QUESTION NO. 794 LEGISLATIVE REFERENDUM NO. 371,FOR THE PROPOSAL - YES,720047,0,0,71,71
TULSA,STATE QUESTION NO. 794 LEGISLATIVE REFERENDUM NO. 371,AGAINST THE PROPOSAL - NO,720047,0,0,68,68
TULSA,STATE QUESTION NO. 794 LEGISLATIVE REFERENDUM NO. 371,FOR THE PROPOSAL - YES,720048,0,0,554,554
TULSA,STATE QUESTION NO. 794 LEGISLATIVE REFERENDUM NO. 371,AGAINST THE PROPOSAL - NO,720048,0,0,282,282
TULSA,STATE QUESTION NO. 794 LEGISLATIVE REFERENDUM NO. 371,FOR THE PROPOSAL - YES,720049,0,0,214,214
TULSA,STATE QUESTION NO. 794 LEGISLATIVE REFERENDUM NO. 371,AGAINST THE PROPOSAL - NO,720049,0,0,141,141
TULSA,STATE QUESTION NO. 794 LEGISLATIVE REFERENDUM NO. 371,FOR THE PROPOSAL - YES,720050,0,0,306,306
TULSA,STATE QUESTION NO. 794 LEGISLATIVE REFERENDUM NO. 371,AGAINST THE PROPOSAL - NO,720050,0,0,156,156
TULSA,STATE QUESTION NO. 794 LEGISLATIVE REFERENDUM NO. 371,FOR THE PROPOSAL - YES,720051,0,0,403,403
TULSA,STATE QUESTION NO. 794 LEGISLATIVE REFERENDUM NO. 371,AGAINST THE PROPOSAL - NO,720051,0,0,211,211
TULSA,STATE QUESTION NO. 794 LEGISLATIVE REFERENDUM NO. 371,FOR THE PROPOSAL - YES,720052,0,0,812,812
TULSA,STATE QUESTION NO. 794 LEGISLATIVE REFERENDUM NO. 371,AGAINST THE PROPOSAL - NO,720052,0,0,377,377
TULSA,STATE QUESTION NO. 794 LEGISLATIVE REFERENDUM NO. 371,FOR THE PROPOSAL - YES,720053,0,0,628,628
TULSA,STATE QUESTION NO. 794 LEGISLATIVE REFERENDUM NO. 371,AGAINST THE PROPOSAL - NO,720053,0,0,133,133
TULSA,STATE QUESTION NO. 794 LEGISLATIVE REFERENDUM NO. 371,FOR THE PROPOSAL - YES,720054,0,0,730,730
TULSA,STATE QUESTION NO. 794 LEGISLATIVE REFERENDUM NO. 371,AGAINST THE PROPOSAL - NO,720054,0,0,332,332
TULSA,STATE QUESTION NO. 794 LEGISLATIVE REFERENDUM NO. 371,FOR THE PROPOSAL - YES,720055,0,0,408,408
TULSA,STATE QUESTION NO. 794 LEGISLATIVE REFERENDUM NO. 371,AGAINST THE PROPOSAL - NO,720055,0,0,162,162
TULSA,STATE QUESTION NO. 794 LEGISLATIVE REFERENDUM NO. 371,FOR THE PROPOSAL - YES,720056,0,0,487,487
TULSA,STATE QUESTION NO. 794 LEGISLATIVE REFERENDUM NO. 371,AGAINST THE PROPOSAL - NO,720056,0,0,135,135
TULSA,STATE QUESTION NO. 794 LEGISLATIVE REFERENDUM NO. 371,FOR THE PROPOSAL - YES,720057,0,0,191,191
TULSA,STATE QUESTION NO. 794 LEGISLATIVE REFERENDUM NO. 371,AGAINST THE PROPOSAL - NO,720057,0,0,54,54
TULSA,STATE QUESTION NO. 794 LEGISLATIVE REFERENDUM NO. 371,FOR THE PROPOSAL - YES,720058,0,0,284,284
TULSA,STATE QUESTION NO. 794 LEGISLATIVE REFERENDUM NO. 371,AGAINST THE PROPOSAL - NO,720058,0,0,71,71
TULSA,STATE QUESTION NO. 794 LEGISLATIVE REFERENDUM NO. 371,FOR THE PROPOSAL - YES,720059,0,0,304,304
TULSA,STATE QUESTION NO. 794 LEGISLATIVE REFERENDUM NO. 371,AGAINST THE PROPOSAL - NO,720059,0,0,68,68
TULSA,STATE QUESTION NO. 794 LEGISLATIVE REFERENDUM NO. 371,FOR THE PROPOSAL - YES,720060,0,0,470,470
TULSA,STATE QUESTION NO. 794 LEGISLATIVE REFERENDUM NO. 371,AGAINST THE PROPOSAL - NO,720060,0,0,87,87
TULSA,STATE QUESTION NO. 794 LEGISLATIVE REFERENDUM NO. 371,FOR THE PROPOSAL - YES,720061,0,0,561,561
TULSA,STATE QUESTION NO. 794 LEGISLATIVE REFERENDUM NO. 371,AGAINST THE PROPOSAL - NO,720061,0,0,112,112
TULSA,STATE QUESTION NO. 794 LEGISLATIVE REFERENDUM NO. 371,FOR THE PROPOSAL - YES,720062,0,0,879,879
TULSA,STATE QUESTION NO. 794 LEGISLATIVE REFERENDUM NO. 371,AGAINST THE PROPOSAL - NO,720062,0,0,361,361
TULSA,STATE QUESTION NO. 794 LEGISLATIVE REFERENDUM NO. 371,FOR THE PROPOSAL - YES,720063,0,0,314,314
TULSA,STATE QUESTION NO. 794 LEGISLATIVE REFERENDUM NO. 371,AGAINST THE PROPOSAL - NO,720063,0,0,140,140
TULSA,STATE QUESTION NO. 794 LEGISLATIVE REFERENDUM NO. 371,FOR THE PROPOSAL - YES,720064,0,0,531,531
TULSA,STATE QUESTION NO. 794 LEGISLATIVE REFERENDUM NO. 371,AGAINST THE PROPOSAL - NO,720064,0,0,198,198
TULSA,STATE QUESTION NO. 794 LEGISLATIVE REFERENDUM NO. 371,FOR THE PROPOSAL - YES,720065,0,0,624,624
TULSA,STATE QUESTION NO. 794 LEGISLATIVE REFERENDUM NO. 371,AGAINST THE PROPOSAL - NO,720065,0,0,201,201
TULSA,STATE QUESTION NO. 794 LEGISLATIVE REFERENDUM NO. 371,FOR THE PROPOSAL - YES,720066,0,0,558,558
TULSA,STATE QUESTION NO. 794 LEGISLATIVE REFERENDUM NO. 371,AGAINST THE PROPOSAL - NO,720066,0,0,224,224
TULSA,STATE QUESTION NO. 794 LEGISLATIVE REFERENDUM NO. 371,FOR THE PROPOSAL - YES,720067,0,0,529,529
TULSA,STATE QUESTION NO. 794 LEGISLATIVE REFERENDUM NO. 371,AGAINST THE PROPOSAL - NO,720067,0,0,209,209
TULSA,STATE QUESTION NO. 794 LEGISLATIVE REFERENDUM NO. 371,FOR THE PROPOSAL - YES,720068,0,0,410,410
TULSA,STATE QUESTION NO. 794 LEGISLATIVE REFERENDUM NO. 371,AGAINST THE PROPOSAL - NO,720068,0,0,157,157
TULSA,STATE QUESTION NO. 794 LEGISLATIVE REFERENDUM NO. 371,FOR THE PROPOSAL - YES,720069,0,0,843,843
TULSA,STATE QUESTION NO. 794 LEGISLATIVE REFERENDUM NO. 371,AGAINST THE PROPOSAL - NO,720069,0,0,300,300
TULSA,STATE QUESTION NO. 794 LEGISLATIVE REFERENDUM NO. 371,FOR THE PROPOSAL - YES,720070,0,0,169,169
TULSA,STATE QUESTION NO. 794 LEGISLATIVE REFERENDUM NO. 371,AGAINST THE PROPOSAL - NO,720070,0,0,46,46
TULSA,STATE QUESTION NO. 794 LEGISLATIVE REFERENDUM NO. 371,FOR THE PROPOSAL - YES,720071,0,0,1128,1128
TULSA,STATE QUESTION NO. 794 LEGISLATIVE REFERENDUM NO. 371,AGAINST THE PROPOSAL - NO,720071,0,0,448,448
TULSA,STATE QUESTION NO. 794 LEGISLATIVE REFERENDUM NO. 371,FOR THE PROPOSAL - YES,720072,0,0,458,458
TULSA,STATE QUESTION NO. 794 LEGISLATIVE REFERENDUM NO. 371,AGAINST THE PROPOSAL - NO,720072,0,0,161,161
TULSA,STATE QUESTION NO. 794 LEGISLATIVE REFERENDUM NO. 371,FOR THE PROPOSAL - YES,720073,0,0,454,454
TULSA,STATE QUESTION NO. 794 LEGISLATIVE REFERENDUM NO. 371,AGAINST THE PROPOSAL - NO,720073,0,0,129,129
TULSA,STATE QUESTION NO. 794 LEGISLATIVE REFERENDUM NO. 371,FOR THE PROPOSAL - YES,720074,0,0,688,688
TULSA,STATE QUESTION NO. 794 LEGISLATIVE REFERENDUM NO. 371,AGAINST THE PROPOSAL - NO,720074,0,0,184,184
TULSA,STATE QUESTION NO. 794 LEGISLATIVE REFERENDUM NO. 371,FOR THE PROPOSAL - YES,720075,0,0,375,375
TULSA,STATE QUESTION NO. 794 LEGISLATIVE REFERENDUM NO. 371,AGAINST THE PROPOSAL - NO,720075,0,0,139,139
TULSA,STATE QUESTION NO. 794 LEGISLATIVE REFERENDUM NO. 371,FOR THE PROPOSAL - YES,720076,0,0,531,531
TULSA,STATE QUESTION NO. 794 LEGISLATIVE REFERENDUM NO. 371,AGAINST THE PROPOSAL - NO,720076,0,0,199,199
TULSA,STATE QUESTION NO. 794 LEGISLATIVE REFERENDUM NO. 371,FOR THE PROPOSAL - YES,720077,0,0,592,592
TULSA,STATE QUESTION NO. 794 LEGISLATIVE REFERENDUM NO. 371,AGAINST THE PROPOSAL - NO,720077,0,0,262,262
TULSA,STATE QUESTION NO. 794 LEGISLATIVE REFERENDUM NO. 371,FOR THE PROPOSAL - YES,720078,0,0,633,633
TULSA,STATE QUESTION NO. 794 LEGISLATIVE REFERENDUM NO. 371,AGAINST THE PROPOSAL - NO,720078,0,0,191,191
TULSA,STATE QUESTION NO. 794 LEGISLATIVE REFERENDUM NO. 371,FOR THE PROPOSAL - YES,720079,0,0,596,596
TULSA,STATE QUESTION NO. 794 LEGISLATIVE REFERENDUM NO. 371,AGAINST THE PROPOSAL - NO,720079,0,0,245,245
TULSA,STATE QUESTION NO. 794 LEGISLATIVE REFERENDUM NO. 371,FOR THE PROPOSAL - YES,720080,0,0,121,121
TULSA,STATE QUESTION NO. 794 LEGISLATIVE REFERENDUM NO. 371,AGAINST THE PROPOSAL - NO,720080,0,0,54,54
TULSA,STATE QUESTION NO. 794 LEGISLATIVE REFERENDUM NO. 371,FOR THE PROPOSAL - YES,720081,0,0,732,732
TULSA,STATE QUESTION NO. 794 LEGISLATIVE REFERENDUM NO. 371,AGAINST THE PROPOSAL - NO,720081,0,0,246,246
TULSA,STATE QUESTION NO. 794 LEGISLATIVE REFERENDUM NO. 371,FOR THE PROPOSAL - YES,720082,0,0,481,481
TULSA,STATE QUESTION NO. 794 LEGISLATIVE REFERENDUM NO. 371,AGAINST THE PROPOSAL - NO,720082,0,0,141,141
TULSA,STATE QUESTION NO. 794 LEGISLATIVE REFERENDUM NO. 371,FOR THE PROPOSAL - YES,720083,0,0,434,434
TULSA,STATE QUESTION NO. 794 LEGISLATIVE REFERENDUM NO. 371,AGAINST THE PROPOSAL - NO,720083,0,0,202,202
TULSA,STATE QUESTION NO. 794 LEGISLATIVE REFERENDUM NO. 371,FOR THE PROPOSAL - YES,720084,0,0,429,429
TULSA,STATE QUESTION NO. 794 LEGISLATIVE REFERENDUM NO. 371,AGAINST THE PROPOSAL - NO,720084,0,0,156,156
TULSA,STATE QUESTION NO. 794 LEGISLATIVE REFERENDUM NO. 371,FOR THE PROPOSAL - YES,720085,0,0,194,194
TULSA,STATE QUESTION NO. 794 LEGISLATIVE REFERENDUM NO. 371,AGAINST THE PROPOSAL - NO,720085,0,0,90,90
TULSA,STATE QUESTION NO. 794 LEGISLATIVE REFERENDUM NO. 371,FOR THE PROPOSAL - YES,720086,0,0,596,596
TULSA,STATE QUESTION NO. 794 LEGISLATIVE REFERENDUM NO. 371,AGAINST THE PROPOSAL - NO,720086,0,0,167,167
TULSA,STATE QUESTION NO. 794 LEGISLATIVE REFERENDUM NO. 371,FOR THE PROPOSAL - YES,720087,0,0,558,558
TULSA,STATE QUESTION NO. 794 LEGISLATIVE REFERENDUM NO. 371,AGAINST THE PROPOSAL - NO,720087,0,0,150,150
TULSA,STATE QUESTION NO. 794 LEGISLATIVE REFERENDUM NO. 371,FOR THE PROPOSAL - YES,720088,0,0,141,141
TULSA,STATE QUESTION NO. 794 LEGISLATIVE REFERENDUM NO. 371,AGAINST THE PROPOSAL - NO,720088,0,0,41,41
TULSA,STATE QUESTION NO. 794 LEGISLATIVE REFERENDUM NO. 371,FOR THE PROPOSAL - YES,720089,0,0,270,270
TULSA,STATE QUESTION NO. 794 LEGISLATIVE REFERENDUM NO. 371,AGAINST THE PROPOSAL - NO,720089,0,0,76,76
TULSA,STATE QUESTION NO. 794 LEGISLATIVE REFERENDUM NO. 371,FOR THE PROPOSAL - YES,720090,0,0,178,178
TULSA,STATE QUESTION NO. 794 LEGISLATIVE REFERENDUM NO. 371,AGAINST THE PROPOSAL - NO,720090,0,0,46,46
TULSA,STATE QUESTION NO. 794 LEGISLATIVE REFERENDUM NO. 371,FOR THE PROPOSAL - YES,720091,0,0,344,344
TULSA,STATE QUESTION NO. 794 LEGISLATIVE REFERENDUM NO. 371,AGAINST THE PROPOSAL - NO,720091,0,0,105,105
TULSA,STATE QUESTION NO. 794 LEGISLATIVE REFERENDUM NO. 371,FOR THE PROPOSAL - YES,720092,0,0,314,314
TULSA,STATE QUESTION NO. 794 LEGISLATIVE REFERENDUM NO. 371,AGAINST THE PROPOSAL - NO,720092,0,0,70,70
TULSA,STATE QUESTION NO. 794 LEGISLATIVE REFERENDUM NO. 371,FOR THE PROPOSAL - YES,720093,0,0,300,300
TULSA,STATE QUESTION NO. 794 LEGISLATIVE REFERENDUM NO. 371,AGAINST THE PROPOSAL - NO,720093,0,0,79,79
TULSA,STATE QUESTION NO. 794 LEGISLATIVE REFERENDUM NO. 371,FOR THE PROPOSAL - YES,720094,0,0,489,489
TULSA,STATE QUESTION NO. 794 LEGISLATIVE REFERENDUM NO. 371,AGAINST THE PROPOSAL - NO,720094,0,0,137,137
TULSA,STATE QUESTION NO. 794 LEGISLATIVE REFERENDUM NO. 371,FOR THE PROPOSAL - YES,720095,0,0,443,443
TULSA,STATE QUESTION NO. 794 LEGISLATIVE REFERENDUM NO. 371,AGAINST THE PROPOSAL - NO,720095,0,0,114,114
TULSA,STATE QUESTION NO. 794 LEGISLATIVE REFERENDUM NO. 371,FOR THE PROPOSAL - YES,720096,0,0,339,339
TULSA,STATE QUESTION NO. 794 LEGISLATIVE REFERENDUM NO. 371,AGAINST THE PROPOSAL - NO,720096,0,0,101,101
TULSA,STATE QUESTION NO. 794 LEGISLATIVE REFERENDUM NO. 371,FOR THE PROPOSAL - YES,720097,0,0,535,535
TULSA,STATE QUESTION NO. 794 LEGISLATIVE REFERENDUM NO. 371,AGAINST THE PROPOSAL - NO,720097,0,0,139,139
TULSA,STATE QUESTION NO. 794 LEGISLATIVE REFERENDUM NO. 371,FOR THE PROPOSAL - YES,720098,0,0,356,356
TULSA,STATE QUESTION NO. 794 LEGISLATIVE REFERENDUM NO. 371,AGAINST THE PROPOSAL - NO,720098,0,0,100,100
TULSA,STATE QUESTION NO. 794 LEGISLATIVE REFERENDUM NO. 371,FOR THE PROPOSAL - YES,720099,0,0,279,279
TULSA,STATE QUESTION NO. 794 LEGISLATIVE REFERENDUM NO. 371,AGAINST THE PROPOSAL - NO,720099,0,0,67,67
TULSA,STATE QUESTION NO. 794 LEGISLATIVE REFERENDUM NO. 371,FOR THE PROPOSAL - YES,720100,0,0,168,168
TULSA,STATE QUESTION NO. 794 LEGISLATIVE REFERENDUM NO. 371,AGAINST THE PROPOSAL - NO,720100,0,0,39,39
TULSA,STATE QUESTION NO. 794 LEGISLATIVE REFERENDUM NO. 371,FOR THE PROPOSAL - YES,720101,0,0,596,596
TULSA,STATE QUESTION NO. 794 LEGISLATIVE REFERENDUM NO. 371,AGAINST THE PROPOSAL - NO,720101,0,0,127,127
TULSA,STATE QUESTION NO. 794 LEGISLATIVE REFERENDUM NO. 371,FOR THE PROPOSAL - YES,720102,0,0,446,446
TULSA,STATE QUESTION NO. 794 LEGISLATIVE REFERENDUM NO. 371,AGAINST THE PROPOSAL - NO,720102,0,0,121,121
TULSA,STATE QUESTION NO. 794 LEGISLATIVE REFERENDUM NO. 371,FOR THE PROPOSAL - YES,720103,0,0,273,273
TULSA,STATE QUESTION NO. 794 LEGISLATIVE REFERENDUM NO. 371,AGAINST THE PROPOSAL - NO,720103,0,0,76,76
TULSA,STATE QUESTION NO. 794 LEGISLATIVE REFERENDUM NO. 371,FOR THE PROPOSAL - YES,720104,0,0,364,364
TULSA,STATE QUESTION NO. 794 LEGISLATIVE REFERENDUM NO. 371,AGAINST THE PROPOSAL - NO,720104,0,0,89,89
TULSA,STATE QUESTION NO. 794 LEGISLATIVE REFERENDUM NO. 371,FOR THE PROPOSAL - YES,720105,0,0,478,478
TULSA,STATE QUESTION NO. 794 LEGISLATIVE REFERENDUM NO. 371,AGAINST THE PROPOSAL - NO,720105,0,0,109,109
TULSA,STATE QUESTION NO. 794 LEGISLATIVE REFERENDUM NO. 371,FOR THE PROPOSAL - YES,720106,0,0,347,347
TULSA,STATE QUESTION NO. 794 LEGISLATIVE REFERENDUM NO. 371,AGAINST THE PROPOSAL - NO,720106,0,0,106,106
TULSA,STATE QUESTION NO. 794 LEGISLATIVE REFERENDUM NO. 371,FOR THE PROPOSAL - YES,720107,0,0,612,612
TULSA,STATE QUESTION NO. 794 LEGISLATIVE REFERENDUM NO. 371,AGAINST THE PROPOSAL - NO,720107,0,0,189,189
TULSA,STATE QUESTION NO. 794 LEGISLATIVE REFERENDUM NO. 371,FOR THE PROPOSAL - YES,720108,0,0,375,375
TULSA,STATE QUESTION NO. 794 LEGISLATIVE REFERENDUM NO. 371,AGAINST THE PROPOSAL - NO,720108,0,0,103,103
TULSA,STATE QUESTION NO. 794 LEGISLATIVE REFERENDUM NO. 371,FOR THE PROPOSAL - YES,720109,0,0,314,314
TULSA,STATE QUESTION NO. 794 LEGISLATIVE REFERENDUM NO. 371,AGAINST THE PROPOSAL - NO,720109,0,0,82,82
TULSA,STATE QUESTION NO. 794 LEGISLATIVE REFERENDUM NO. 371,FOR THE PROPOSAL - YES,720110,0,0,421,421
TULSA,STATE QUESTION NO. 794 LEGISLATIVE REFERENDUM NO. 371,AGAINST THE PROPOSAL - NO,720110,0,0,125,125
TULSA,STATE QUESTION NO. 794 LEGISLATIVE REFERENDUM NO. 371,FOR THE PROPOSAL - YES,720111,0,0,339,339
TULSA,STATE QUESTION NO. 794 LEGISLATIVE REFERENDUM NO. 371,AGAINST THE PROPOSAL - NO,720111,0,0,92,92
TULSA,STATE QUESTION NO. 794 LEGISLATIVE REFERENDUM NO. 371,FOR THE PROPOSAL - YES,720112,0,0,374,374
TULSA,STATE QUESTION NO. 794 LEGISLATIVE REFERENDUM NO. 371,AGAINST THE PROPOSAL - NO,720112,0,0,117,117
TULSA,STATE QUESTION NO. 794 LEGISLATIVE REFERENDUM NO. 371,FOR THE PROPOSAL - YES,720113,0,0,458,458
TULSA,STATE QUESTION NO. 794 LEGISLATIVE REFERENDUM NO. 371,AGAINST THE PROPOSAL - NO,720113,0,0,115,115
TULSA,STATE QUESTION NO. 794 LEGISLATIVE REFERENDUM NO. 371,FOR THE PROPOSAL - YES,720114,0,0,291,291
TULSA,STATE QUESTION NO. 794 LEGISLATIVE REFERENDUM NO. 371,AGAINST THE PROPOSAL - NO,720114,0,0,109,109
TULSA,STATE QUESTION NO. 794 LEGISLATIVE REFERENDUM NO. 371,FOR THE PROPOSAL - YES,720115,0,0,337,337
TULSA,STATE QUESTION NO. 794 LEGISLATIVE REFERENDUM NO. 371,AGAINST THE PROPOSAL - NO,720115,0,0,120,120
TULSA,STATE QUESTION NO. 794 LEGISLATIVE REFERENDUM NO. 371,FOR THE PROPOSAL - YES,720116,0,0,533,533
TULSA,STATE QUESTION NO. 794 LEGISLATIVE REFERENDUM NO. 371,AGAINST THE PROPOSAL - NO,720116,0,0,126,126
TULSA,STATE QUESTION NO. 794 LEGISLATIVE REFERENDUM NO. 371,FOR THE PROPOSAL - YES,720117,0,0,1093,1093
TULSA,STATE QUESTION NO. 794 LEGISLATIVE REFERENDUM NO. 371,AGAINST THE PROPOSAL - NO,720117,0,0,288,288
TULSA,STATE QUESTION NO. 794 LEGISLATIVE REFERENDUM NO. 371,FOR THE PROPOSAL - YES,720118,0,0,877,877
TULSA,STATE QUESTION NO. 794 LEGISLATIVE REFERENDUM NO. 371,AGAINST THE PROPOSAL - NO,720118,0,0,199,199
TULSA,STATE QUESTION NO. 794 LEGISLATIVE REFERENDUM NO. 371,FOR THE PROPOSAL - YES,720119,0,0,568,568
TULSA,STATE QUESTION NO. 794 LEGISLATIVE REFERENDUM NO. 371,AGAINST THE PROPOSAL - NO,720119,0,0,127,127
TULSA,STATE QUESTION NO. 794 LEGISLATIVE REFERENDUM NO. 371,FOR THE PROPOSAL - YES,720120,0,0,368,368
TULSA,STATE QUESTION NO. 794 LEGISLATIVE REFERENDUM NO. 371,AGAINST THE PROPOSAL - NO,720120,0,0,118,118
TULSA,STATE QUESTION NO. 794 LEGISLATIVE REFERENDUM NO. 371,FOR THE PROPOSAL - YES,720121,0,0,593,593
TULSA,STATE QUESTION NO. 794 LEGISLATIVE REFERENDUM NO. 371,AGAINST THE PROPOSAL - NO,720121,0,0,223,223
TULSA,STATE QUESTION NO. 794 LEGISLATIVE REFERENDUM NO. 371,FOR THE PROPOSAL - YES,720122,0,0,309,309
TULSA,STATE QUESTION NO. 794 LEGISLATIVE REFERENDUM NO. 371,AGAINST THE PROPOSAL - NO,720122,0,0,69,69
TULSA,STATE QUESTION NO. 794 LEGISLATIVE REFERENDUM NO. 371,FOR THE PROPOSAL - YES,720123,0,0,695,695
TULSA,STATE QUESTION NO. 794 LEGISLATIVE REFERENDUM NO. 371,AGAINST THE PROPOSAL - NO,720123,0,0,200,200
TULSA,STATE QUESTION NO. 794 LEGISLATIVE REFERENDUM NO. 371,FOR THE PROPOSAL - YES,720124,0,0,652,652
TULSA,STATE QUESTION NO. 794 LEGISLATIVE REFERENDUM NO. 371,AGAINST THE PROPOSAL - NO,720124,0,0,160,160
TULSA,STATE QUESTION NO. 794 LEGISLATIVE REFERENDUM NO. 371,FOR THE PROPOSAL - YES,720125,0,0,581,581
TULSA,STATE QUESTION NO. 794 LEGISLATIVE REFERENDUM NO. 371,AGAINST THE PROPOSAL - NO,720125,0,0,184,184
TULSA,STATE QUESTION NO. 794 LEGISLATIVE REFERENDUM NO. 371,FOR THE PROPOSAL - YES,720126,0,0,562,562
TULSA,STATE QUESTION NO. 794 LEGISLATIVE REFERENDUM NO. 371,AGAINST THE PROPOSAL - NO,720126,0,0,163,163
TULSA,STATE QUESTION NO. 794 LEGISLATIVE REFERENDUM NO. 371,FOR THE PROPOSAL - YES,720127,0,0,367,367
TULSA,STATE QUESTION NO. 794 LEGISLATIVE REFERENDUM NO. 371,AGAINST THE PROPOSAL - NO,720127,0,0,108,108
TULSA,STATE QUESTION NO. 794 LEGISLATIVE REFERENDUM NO. 371,FOR THE PROPOSAL - YES,720128,0,0,591,591
TULSA,STATE QUESTION NO. 794 LEGISLATIVE REFERENDUM NO. 371,AGAINST THE PROPOSAL - NO,720128,0,0,167,167
TULSA,STATE QUESTION NO. 794 LEGISLATIVE REFERENDUM NO. 371,FOR THE PROPOSAL - YES,720129,0,0,569,569
TULSA,STATE QUESTION NO. 794 LEGISLATIVE REFERENDUM NO. 371,AGAINST THE PROPOSAL - NO,720129,0,0,158,158
TULSA,STATE QUESTION NO. 794 LEGISLATIVE REFERENDUM NO. 371,FOR THE PROPOSAL - YES,720130,0,0,580,580
TULSA,STATE QUESTION NO. 794 LEGISLATIVE REFERENDUM NO. 371,AGAINST THE PROPOSAL - NO,720130,0,0,149,149
TULSA,STATE QUESTION NO. 794 LEGISLATIVE REFERENDUM NO. 371,FOR THE PROPOSAL - YES,720131,0,0,117,117
TULSA,STATE QUESTION NO. 794 LEGISLATIVE REFERENDUM NO. 371,AGAINST THE PROPOSAL - NO,720131,0,0,39,39
TULSA,STATE QUESTION NO. 794 LEGISLATIVE REFERENDUM NO. 371,FOR THE PROPOSAL - YES,720132,0,0,527,527
TULSA,STATE QUESTION NO. 794 LEGISLATIVE REFERENDUM NO. 371,AGAINST THE PROPOSAL - NO,720132,0,0,134,134
TULSA,STATE QUESTION NO. 794 LEGISLATIVE REFERENDUM NO. 371,FOR THE PROPOSAL - YES,720133,0,0,550,550
TULSA,STATE QUESTION NO. 794 LEGISLATIVE REFERENDUM NO. 371,AGAINST THE PROPOSAL - NO,720133,0,0,157,157
TULSA,STATE QUESTION NO. 794 LEGISLATIVE REFERENDUM NO. 371,FOR THE PROPOSAL - YES,720134,0,0,613,613
TULSA,STATE QUESTION NO. 794 LEGISLATIVE REFERENDUM NO. 371,AGAINST THE PROPOSAL - NO,720134,0,0,170,170
TULSA,STATE QUESTION NO. 794 LEGISLATIVE REFERENDUM NO. 371,FOR THE PROPOSAL - YES,720135,0,0,764,764
TULSA,STATE QUESTION NO. 794 LEGISLATIVE REFERENDUM NO. 371,AGAINST THE PROPOSAL - NO,720135,0,0,247,247
TULSA,STATE QUESTION NO. 794 LEGISLATIVE REFERENDUM NO. 371,FOR THE PROPOSAL - YES,720136,0,0,597,597
TULSA,STATE QUESTION NO. 794 LEGISLATIVE REFERENDUM NO. 371,AGAINST THE PROPOSAL - NO,720136,0,0,151,151
TULSA,STATE QUESTION NO. 794 LEGISLATIVE REFERENDUM NO. 371,FOR THE PROPOSAL - YES,720137,0,0,352,352
TULSA,STATE QUESTION NO. 794 LEGISLATIVE REFERENDUM NO. 371,AGAINST THE PROPOSAL - NO,720137,0,0,88,88
TULSA,STATE QUESTION NO. 794 LEGISLATIVE REFERENDUM NO. 371,FOR THE PROPOSAL - YES,720138,0,0,78,78
TULSA,STATE QUESTION NO. 794 LEGISLATIVE REFERENDUM NO. 371,AGAINST THE PROPOSAL - NO,720138,0,0,30,30
TULSA,STATE QUESTION NO. 794 LEGISLATIVE REFERENDUM NO. 371,FOR THE PROPOSAL - YES,720139,0,0,281,281
TULSA,STATE QUESTION NO. 794 LEGISLATIVE REFERENDUM NO. 371,AGAINST THE PROPOSAL - NO,720139,0,0,88,88
TULSA,STATE QUESTION NO. 794 LEGISLATIVE REFERENDUM NO. 371,FOR THE PROPOSAL - YES,720140,0,0,201,201
TULSA,STATE QUESTION NO. 794 LEGISLATIVE REFERENDUM NO. 371,AGAINST THE PROPOSAL - NO,720140,0,0,133,133
TULSA,STATE QUESTION NO. 794 LEGISLATIVE REFERENDUM NO. 371,FOR THE PROPOSAL - YES,720141,0,0,624,624
TULSA,STATE QUESTION NO. 794 LEGISLATIVE REFERENDUM NO. 371,AGAINST THE PROPOSAL - NO,720141,0,0,185,185
TULSA,STATE QUESTION NO. 794 LEGISLATIVE REFERENDUM NO. 371,FOR THE PROPOSAL - YES,720142,0,0,414,414
TULSA,STATE QUESTION NO. 794 LEGISLATIVE REFERENDUM NO. 371,AGAINST THE PROPOSAL - NO,720142,0,0,110,110
TULSA,STATE QUESTION NO. 794 LEGISLATIVE REFERENDUM NO. 371,FOR THE PROPOSAL - YES,720143,0,0,362,362
TULSA,STATE QUESTION NO. 794 LEGISLATIVE REFERENDUM NO. 371,AGAINST THE PROPOSAL - NO,720143,0,0,113,113
TULSA,STATE QUESTION NO. 794 LEGISLATIVE REFERENDUM NO. 371,FOR THE PROPOSAL - YES,720144,0,0,794,794
TULSA,STATE QUESTION NO. 794 LEGISLATIVE REFERENDUM NO. 371,AGAINST THE PROPOSAL - NO,720144,0,0,194,194
TULSA,STATE QUESTION NO. 794 LEGISLATIVE REFERENDUM NO. 371,FOR THE PROPOSAL - YES,720145,0,0,826,826
TULSA,STATE QUESTION NO. 794 LEGISLATIVE REFERENDUM NO. 371,AGAINST THE PROPOSAL - NO,720145,0,0,250,250
TULSA,STATE QUESTION NO. 794 LEGISLATIVE REFERENDUM NO. 371,FOR THE PROPOSAL - YES,720146,0,0,629,629
TULSA,STATE QUESTION NO. 794 LEGISLATIVE REFERENDUM NO. 371,AGAINST THE PROPOSAL - NO,720146,0,0,181,181
TULSA,STATE QUESTION NO. 794 LEGISLATIVE REFERENDUM NO. 371,FOR THE PROPOSAL - YES,720147,0,0,152,152
TULSA,STATE QUESTION NO. 794 LEGISLATIVE REFERENDUM NO. 371,AGAINST THE PROPOSAL - NO,720147,0,0,85,85
TULSA,STATE QUESTION NO. 794 LEGISLATIVE REFERENDUM NO. 371,FOR THE PROPOSAL - YES,720148,0,0,365,365
TULSA,STATE QUESTION NO. 794 LEGISLATIVE REFERENDUM NO. 371,AGAINST THE PROPOSAL - NO,720148,0,0,96,96
TULSA,STATE QUESTION NO. 794 LEGISLATIVE REFERENDUM NO. 371,FOR THE PROPOSAL - YES,720149,0,0,313,313
TULSA,STATE QUESTION NO. 794 LEGISLATIVE REFERENDUM NO. 371,AGAINST THE PROPOSAL - NO,720149,0,0,70,70
TULSA,STATE QUESTION NO. 794 LEGISLATIVE REFERENDUM NO. 371,FOR THE PROPOSAL - YES,720150,0,0,1379,1379
TULSA,STATE QUESTION NO. 794 LEGISLATIVE REFERENDUM NO. 371,AGAINST THE PROPOSAL - NO,720150,0,0,340,340
TULSA,STATE QUESTION NO. 794 LEGISLATIVE REFERENDUM NO. 371,FOR THE PROPOSAL - YES,720151,0,0,271,271
TULSA,STATE QUESTION NO. 794 LEGISLATIVE REFERENDUM NO. 371,AGAINST THE PROPOSAL - NO,720151,0,0,67,67
TULSA,STATE QUESTION NO. 794 LEGISLATIVE REFERENDUM NO. 371,FOR THE PROPOSAL - YES,720152,0,0,790,790
TULSA,STATE QUESTION NO. 794 LEGISLATIVE REFERENDUM NO. 371,AGAINST THE PROPOSAL - NO,720152,0,0,249,249
TULSA,STATE QUESTION NO. 794 LEGISLATIVE REFERENDUM NO. 371,FOR THE PROPOSAL - YES,720153,0,0,669,669
TULSA,STATE QUESTION NO. 794 LEGISLATIVE REFERENDUM NO. 371,AGAINST THE PROPOSAL - NO,720153,0,0,197,197
TULSA,STATE QUESTION NO. 794 LEGISLATIVE REFERENDUM NO. 371,FOR THE PROPOSAL - YES,720154,0,0,841,841
TULSA,STATE QUESTION NO. 794 LEGISLATIVE REFERENDUM NO. 371,AGAINST THE PROPOSAL - NO,720154,0,0,199,199
TULSA,STATE QUESTION NO. 794 LEGISLATIVE REFERENDUM NO. 371,FOR THE PROPOSAL - YES,720155,0,0,1187,1187
TULSA,STATE QUESTION NO. 794 LEGISLATIVE REFERENDUM NO. 371,AGAINST THE PROPOSAL - NO,720155,0,0,323,323
TULSA,STATE QUESTION NO. 794 LEGISLATIVE REFERENDUM NO. 371,FOR THE PROPOSAL - YES,720156,0,0,263,263
TULSA,STATE QUESTION NO. 794 LEGISLATIVE REFERENDUM NO. 371,AGAINST THE PROPOSAL - NO,720156,0,0,69,69
TULSA,STATE QUESTION NO. 794 LEGISLATIVE REFERENDUM NO. 371,FOR THE PROPOSAL - YES,720157,0,0,1153,1153
TULSA,STATE QUESTION NO. 794 LEGISLATIVE REFERENDUM NO. 371,AGAINST THE PROPOSAL - NO,720157,0,0,305,305
TULSA,STATE QUESTION NO. 794 LEGISLATIVE REFERENDUM NO. 371,FOR THE PROPOSAL - YES,720158,0,0,586,586
TULSA,STATE QUESTION NO. 794 LEGISLATIVE REFERENDUM NO. 371,AGAINST THE PROPOSAL - NO,720158,0,0,177,177
TULSA,STATE QUESTION NO. 794 LEGISLATIVE REFERENDUM NO. 371,FOR THE PROPOSAL - YES,720159,0,0,672,672
TULSA,STATE QUESTION NO. 794 LEGISLATIVE REFERENDUM NO. 371,AGAINST THE PROPOSAL - NO,720159,0,0,181,181
TULSA,STATE QUESTION NO. 794 LEGISLATIVE REFERENDUM NO. 371,FOR THE PROPOSAL - YES,720160,0,0,832,832
TULSA,STATE QUESTION NO. 794 LEGISLATIVE REFERENDUM NO. 371,AGAINST THE PROPOSAL - NO,720160,0,0,275,275
TULSA,STATE QUESTION NO. 794 LEGISLATIVE REFERENDUM NO. 371,FOR THE PROPOSAL - YES,720161,0,0,311,311
TULSA,STATE QUESTION NO. 794 LEGISLATIVE REFERENDUM NO. 371,AGAINST THE PROPOSAL - NO,720161,0,0,77,77
TULSA,STATE QUESTION NO. 794 LEGISLATIVE REFERENDUM NO. 371,FOR THE PROPOSAL - YES,720162,0,0,60,60
TULSA,STATE QUESTION NO. 794 LEGISLATIVE REFERENDUM NO. 371,AGAINST THE PROPOSAL - NO,720162,0,0,18,18
TULSA,STATE QUESTION NO. 794 LEGISLATIVE REFERENDUM NO. 371,FOR THE PROPOSAL - YES,720163,0,0,652,652
TULSA,STATE QUESTION NO. 794 LEGISLATIVE REFERENDUM NO. 371,AGAINST THE PROPOSAL - NO,720163,0,0,160,160
TULSA,STATE QUESTION NO. 794 LEGISLATIVE REFERENDUM NO. 371,FOR THE PROPOSAL - YES,720164,0,0,277,277
TULSA,STATE QUESTION NO. 794 LEGISLATIVE REFERENDUM NO. 371,AGAINST THE PROPOSAL - NO,720164,0,0,70,70
TULSA,STATE QUESTION NO. 794 LEGISLATIVE REFERENDUM NO. 371,FOR THE PROPOSAL - YES,720165,0,0,325,325
TULSA,STATE QUESTION NO. 794 LEGISLATIVE REFERENDUM NO. 371,AGAINST THE PROPOSAL - NO,720165,0,0,99,99
TULSA,STATE QUESTION NO. 794 LEGISLATIVE REFERENDUM NO. 371,FOR THE PROPOSAL - YES,720166,0,0,811,811
TULSA,STATE QUESTION NO. 794 LEGISLATIVE REFERENDUM NO. 371,AGAINST THE PROPOSAL - NO,720166,0,0,247,247
TULSA,STATE QUESTION NO. 794 LEGISLATIVE REFERENDUM NO. 371,FOR THE PROPOSAL - YES,720167,0,0,734,734
TULSA,STATE QUESTION NO. 794 LEGISLATIVE REFERENDUM NO. 371,AGAINST THE PROPOSAL - NO,720167,0,0,189,189
TULSA,STATE QUESTION NO. 794 LEGISLATIVE REFERENDUM NO. 371,FOR THE PROPOSAL - YES,720168,0,0,615,615
TULSA,STATE QUESTION NO. 794 LEGISLATIVE REFERENDUM NO. 371,AGAINST THE PROPOSAL - NO,720168,0,0,181,181
TULSA,STATE QUESTION NO. 794 LEGISLATIVE REFERENDUM NO. 371,FOR THE PROPOSAL - YES,720169,0,0,477,477
TULSA,STATE QUESTION NO. 794 LEGISLATIVE REFERENDUM NO. 371,AGAINST THE PROPOSAL - NO,720169,0,0,114,114
TULSA,STATE QUESTION NO. 794 LEGISLATIVE REFERENDUM NO. 371,FOR THE PROPOSAL - YES,720170,0,0,446,446
TULSA,STATE QUESTION NO. 794 LEGISLATIVE REFERENDUM NO. 371,AGAINST THE PROPOSAL - NO,720170,0,0,96,96
TULSA,STATE QUESTION NO. 794 LEGISLATIVE REFERENDUM NO. 371,FOR THE PROPOSAL - YES,720171,0,0,424,424
TULSA,STATE QUESTION NO. 794 LEGISLATIVE REFERENDUM NO. 371,AGAINST THE PROPOSAL - NO,720171,0,0,132,132
TULSA,STATE QUESTION NO. 794 LEGISLATIVE REFERENDUM NO. 371,FOR THE PROPOSAL - YES,720172,0,0,583,583
TULSA,STATE QUESTION NO. 794 LEGISLATIVE REFERENDUM NO. 371,AGAINST THE PROPOSAL - NO,720172,0,0,164,164
TULSA,STATE QUESTION NO. 794 LEGISLATIVE REFERENDUM NO. 371,FOR THE PROPOSAL - YES,720173,0,0,724,724
TULSA,STATE QUESTION NO. 794 LEGISLATIVE REFERENDUM NO. 371,AGAINST THE PROPOSAL - NO,720173,0,0,163,163
TULSA,STATE QUESTION NO. 794 LEGISLATIVE REFERENDUM NO. 371,FOR THE PROPOSAL - YES,720174,0,0,0,0
TULSA,STATE QUESTION NO. 794 LEGISLATIVE REFERENDUM NO. 371,AGAINST THE PROPOSAL - NO,720174,0,0,0,0
TULSA,STATE QUESTION NO. 794 LEGISLATIVE REFERENDUM NO. 371,FOR THE PROPOSAL - YES,720175,0,0,0,0
TULSA,STATE QUESTION NO. 794 LEGISLATIVE REFERENDUM NO. 371,AGAINST THE PROPOSAL - NO,720175,0,0,0,0
TULSA,STATE QUESTION NO. 794 LEGISLATIVE REFERENDUM NO. 371,FOR THE PROPOSAL - YES,720176,0,0,0,0
TULSA,STATE QUESTION NO. 794 LEGISLATIVE REFERENDUM NO. 371,AGAINST THE PROPOSAL - NO,720176,0,0,0,0
TULSA,STATE QUESTION NO. 794 LEGISLATIVE REFERENDUM NO. 371,FOR THE PROPOSAL - YES,720351,0,0,1249,1249
TULSA,STATE QUESTION NO. 794 LEGISLATIVE REFERENDUM NO. 371,AGAINST THE PROPOSAL - NO,720351,0,0,342,342
TULSA,STATE QUESTION NO. 794 LEGISLATIVE REFERENDUM NO. 371,FOR THE PROPOSAL - YES,720352,0,0,582,582
TULSA,STATE QUESTION NO. 794 LEGISLATIVE REFERENDUM NO. 371,AGAINST THE PROPOSAL - NO,720352,0,0,130,130
TULSA,STATE QUESTION NO. 794 LEGISLATIVE REFERENDUM NO. 371,FOR THE PROPOSAL - YES,720353,0,0,120,120
TULSA,STATE QUESTION NO. 794 LEGISLATIVE REFERENDUM NO. 371,AGAINST THE PROPOSAL - NO,720353,0,0,25,25
TULSA,STATE QUESTION NO. 794 LEGISLATIVE REFERENDUM NO. 371,FOR THE PROPOSAL - YES,720354,0,0,106,106
TULSA,STATE QUESTION NO. 794 LEGISLATIVE REFERENDUM NO. 371,AGAINST THE PROPOSAL - NO,720354,0,0,26,26
TULSA,STATE QUESTION NO. 794 LEGISLATIVE REFERENDUM NO. 371,FOR THE PROPOSAL - YES,720355,0,0,147,147
TULSA,STATE QUESTION NO. 794 LEGISLATIVE REFERENDUM NO. 371,AGAINST THE PROPOSAL - NO,720355,0,0,29,29
TULSA,STATE QUESTION NO. 794 LEGISLATIVE REFERENDUM NO. 371,FOR THE PROPOSAL - YES,720356,0,0,171,171
TULSA,STATE QUESTION NO. 794 LEGISLATIVE REFERENDUM NO. 371,AGAINST THE PROPOSAL - NO,720356,0,0,55,55
TULSA,STATE QUESTION NO. 794 LEGISLATIVE REFERENDUM NO. 371,FOR THE PROPOSAL - YES,720400,0,0,1020,1020
TULSA,STATE QUESTION NO. 794 LEGISLATIVE REFERENDUM NO. 371,AGAINST THE PROPOSAL - NO,720400,0,0,309,309
TULSA,STATE QUESTION NO. 794 LEGISLATIVE REFERENDUM NO. 371,FOR THE PROPOSAL - YES,720401,0,0,991,991
TULSA,STATE QUESTION NO. 794 LEGISLATIVE REFERENDUM NO. 371,AGAINST THE PROPOSAL - NO,720401,0,0,283,283
TULSA,STATE QUESTION NO. 794 LEGISLATIVE REFERENDUM NO. 371,FOR THE PROPOSAL - YES,720402,0,0,625,625
TULSA,STATE QUESTION NO. 794 LEGISLATIVE REFERENDUM NO. 371,AGAINST THE PROPOSAL - NO,720402,0,0,169,169
TULSA,STATE QUESTION NO. 794 LEGISLATIVE REFERENDUM NO. 371,FOR THE PROPOSAL - YES,720403,0,0,1225,1225
TULSA,STATE QUESTION NO. 794 LEGISLATIVE REFERENDUM NO. 371,AGAINST THE PROPOSAL - NO,720403,0,0,327,327
TULSA,STATE QUESTION NO. 794 LEGISLATIVE REFERENDUM NO. 371,FOR THE PROPOSAL - YES,720404,0,0,717,717
TULSA,STATE QUESTION NO. 794 LEGISLATIVE REFERENDUM NO. 371,AGAINST THE PROPOSAL - NO,720404,0,0,189,189
TULSA,STATE QUESTION NO. 794 LEGISLATIVE REFERENDUM NO. 371,FOR THE PROPOSAL - YES,720405,0,0,137,137
TULSA,STATE QUESTION NO. 794 LEGISLATIVE REFERENDUM NO. 371,AGAINST THE PROPOSAL - NO,720405,0,0,26,26
TULSA,STATE QUESTION NO. 794 LEGISLATIVE REFERENDUM NO. 371,FOR THE PROPOSAL - YES,720406,0,0,797,797
TULSA,STATE QUESTION NO. 794 LEGISLATIVE REFERENDUM NO. 371,AGAINST THE PROPOSAL - NO,720406,0,0,201,201
TULSA,STATE QUESTION NO. 794 LEGISLATIVE REFERENDUM NO. 371,FOR THE PROPOSAL - YES,720407,0,0,940,940
TULSA,STATE QUESTION NO. 794 LEGISLATIVE REFERENDUM NO. 371,AGAINST THE PROPOSAL - NO,720407,0,0,219,219
TULSA,STATE QUESTION NO. 794 LEGISLATIVE REFERENDUM NO. 371,FOR THE PROPOSAL - YES,720408,0,0,868,868
TULSA,STATE QUESTION NO. 794 LEGISLATIVE REFERENDUM NO. 371,AGAINST THE PROPOSAL - NO,720408,0,0,227,227
TULSA,STATE QUESTION NO. 794 LEGISLATIVE REFERENDUM NO. 371,FOR THE PROPOSAL - YES,720409,0,0,772,772
TULSA,STATE QUESTION NO. 794 LEGISLATIVE REFERENDUM NO. 371,AGAINST THE PROPOSAL - NO,720409,0,0,250,250
TULSA,STATE QUESTION NO. 794 LEGISLATIVE REFERENDUM NO. 371,FOR THE PROPOSAL - YES,720410,0,0,545,545
TULSA,STATE QUESTION NO. 794 LEGISLATIVE REFERENDUM NO. 371,AGAINST THE PROPOSAL - NO,720410,0,0,124,124
TULSA,STATE QUESTION NO. 794 LEGISLATIVE REFERENDUM NO. 371,FOR THE PROPOSAL - YES,720411,0,0,406,406
TULSA,STATE QUESTION NO. 794 LEGISLATIVE REFERENDUM NO. 371,AGAINST THE PROPOSAL - NO,720411,0,0,112,112
TULSA,STATE QUESTION NO. 794 LEGISLATIVE REFERENDUM NO. 371,FOR THE PROPOSAL - YES,720451,0,0,567,567
TULSA,STATE QUESTION NO. 794 LEGISLATIVE REFERENDUM NO. 371,AGAINST THE PROPOSAL - NO,720451,0,0,157,157
TULSA,STATE QUESTION NO. 794 LEGISLATIVE REFERENDUM NO. 371,FOR THE PROPOSAL - YES,720452,0,0,1028,1028
TULSA,STATE QUESTION NO. 794 LEGISLATIVE REFERENDUM NO. 371,AGAINST THE PROPOSAL - NO,720452,0,0,243,243
TULSA,STATE QUESTION NO. 794 LEGISLATIVE REFERENDUM NO. 371,FOR THE PROPOSAL - YES,720453,0,0,663,663
TULSA,STATE QUESTION NO. 794 LEGISLATIVE REFERENDUM NO. 371,AGAINST THE PROPOSAL - NO,720453,0,0,184,184
TULSA,STATE QUESTION NO. 794 LEGISLATIVE REFERENDUM NO. 371,FOR THE PROPOSAL - YES,720454,0,0,955,955
TULSA,STATE QUESTION NO. 794 LEGISLATIVE REFERENDUM NO. 371,AGAINST THE PROPOSAL - NO,720454,0,0,260,260
TULSA,STATE QUESTION NO. 794 LEGISLATIVE REFERENDUM NO. 371,FOR THE PROPOSAL - YES,720455,0,0,393,393
TULSA,STATE QUESTION NO. 794 LEGISLATIVE REFERENDUM NO. 371,AGAINST THE PROPOSAL - NO,720455,0,0,94,94
TULSA,STATE QUESTION NO. 794 LEGISLATIVE REFERENDUM NO. 371,FOR THE PROPOSAL - YES,720456,0,0,596,596
TULSA,STATE QUESTION NO. 794 LEGISLATIVE REFERENDUM NO. 371,AGAINST THE PROPOSAL - NO,720456,0,0,141,141
TULSA,STATE QUESTION NO. 794 LEGISLATIVE REFERENDUM NO. 371,FOR THE PROPOSAL - YES,720457,0,0,10,10
TULSA,STATE QUESTION NO. 794 LEGISLATIVE REFERENDUM NO. 371,AGAINST THE PROPOSAL - NO,720457,0,0,5,5
TULSA,STATE QUESTION NO. 794 LEGISLATIVE REFERENDUM NO. 371,FOR THE PROPOSAL - YES,720458,0,0,1166,1166
TULSA,STATE QUESTION NO. 794 LEGISLATIVE REFERENDUM NO. 371,AGAINST THE PROPOSAL - NO,720458,0,0,305,305
TULSA,STATE QUESTION NO. 794 LEGISLATIVE REFERENDUM NO. 371,FOR THE PROPOSAL - YES,720459,0,0,414,414
TULSA,STATE QUESTION NO. 794 LEGISLATIVE REFERENDUM NO. 371,AGAINST THE PROPOSAL - NO,720459,0,0,111,111
TULSA,STATE QUESTION NO. 794 LEGISLATIVE REFERENDUM NO. 371,FOR THE PROPOSAL - YES,720460,0,0,593,593
TULSA,STATE QUESTION NO. 794 LEGISLATIVE REFERENDUM NO. 371,AGAINST THE PROPOSAL - NO,720460,0,0,175,175
TULSA,STATE QUESTION NO. 794 LEGISLATIVE REFERENDUM NO. 371,FOR THE PROPOSAL - YES,720461,0,0,570,570
TULSA,STATE QUESTION NO. 794 LEGISLATIVE REFERENDUM NO. 371,AGAINST THE PROPOSAL - NO,720461,0,0,171,171
TULSA,STATE QUESTION NO. 794 LEGISLATIVE REFERENDUM NO. 371,FOR THE PROPOSAL - YES,720462,0,0,886,886
TULSA,STATE QUESTION NO. 794 LEGISLATIVE REFERENDUM NO. 371,AGAINST THE PROPOSAL - NO,720462,0,0,265,265
TULSA,STATE QUESTION NO. 794 LEGISLATIVE REFERENDUM NO. 371,FOR THE PROPOSAL - YES,720463,0,0,577,577
TULSA,STATE QUESTION NO. 794 LEGISLATIVE REFERENDUM NO. 371,AGAINST THE PROPOSAL - NO,720463,0,0,141,141
TULSA,STATE QUESTION NO. 794 LEGISLATIVE REFERENDUM NO. 371,FOR THE PROPOSAL - YES,720464,0,0,1138,1138
TULSA,STATE QUESTION NO. 794 LEGISLATIVE REFERENDUM NO. 371,AGAINST THE PROPOSAL - NO,720464,0,0,306,306
TULSA,STATE QUESTION NO. 794 LEGISLATIVE REFERENDUM NO. 371,FOR THE PROPOSAL - YES,720465,0,0,936,936
TULSA,STATE QUESTION NO. 794 LEGISLATIVE REFERENDUM NO. 371,AGAINST THE PROPOSAL - NO,720465,0,0,265,265
TULSA,STATE QUESTION NO. 794 LEGISLATIVE REFERENDUM NO. 371,FOR THE PROPOSAL - YES,720466,0,0,794,794
TULSA,STATE QUESTION NO. 794 LEGISLATIVE REFERENDUM NO. 371,AGAINST THE PROPOSAL - NO,720466,0,0,217,217
TULSA,STATE QUESTION NO. 794 LEGISLATIVE REFERENDUM NO. 371,FOR THE PROPOSAL - YES,720467,0,0,300,300
TULSA,STATE QUESTION NO. 794 LEGISLATIVE REFERENDUM NO. 371,AGAINST THE PROPOSAL - NO,720467,0,0,82,82
TULSA,STATE QUESTION NO. 794 LEGISLATIVE REFERENDUM NO. 371,FOR THE PROPOSAL - YES,720468,0,0,991,991
TULSA,STATE QUESTION NO. 794 LEGISLATIVE REFERENDUM NO. 371,AGAINST THE PROPOSAL - NO,720468,0,0,269,269
TULSA,STATE QUESTION NO. 794 LEGISLATIVE REFERENDUM NO. 371,FOR THE PROPOSAL - YES,720469,0,0,237,237
TULSA,STATE QUESTION NO. 794 LEGISLATIVE REFERENDUM NO. 371,AGAINST THE PROPOSAL - NO,720469,0,0,50,50
TULSA,STATE QUESTION NO. 794 LEGISLATIVE REFERENDUM NO. 371,FOR THE PROPOSAL - YES,720470,0,0,965,965
TULSA,STATE QUESTION NO. 794 LEGISLATIVE REFERENDUM NO. 371,AGAINST THE PROPOSAL - NO,720470,0,0,277,277
TULSA,STATE QUESTION NO. 794 LEGISLATIVE REFERENDUM NO. 371,FOR THE PROPOSAL - YES,720471,0,0,457,457
TULSA,STATE QUESTION NO. 794 LEGISLATIVE REFERENDUM NO. 371,AGAINST THE PROPOSAL - NO,720471,0,0,110,110
TULSA,STATE QUESTION NO. 794 LEGISLATIVE REFERENDUM NO. 371,FOR THE PROPOSAL - YES,720472,0,0,363,363
TULSA,STATE QUESTION NO. 794 LEGISLATIVE REFERENDUM NO. 371,AGAINST THE PROPOSAL - NO,720472,0,0,97,97
TULSA,STATE QUESTION NO. 794 LEGISLATIVE REFERENDUM NO. 371,FOR THE PROPOSAL - YES,720473,0,0,559,559
TULSA,STATE QUESTION NO. 794 LEGISLATIVE REFERENDUM NO. 371,AGAINST THE PROPOSAL - NO,720473,0,0,137,137
TULSA,STATE QUESTION NO. 794 LEGISLATIVE REFERENDUM NO. 371,FOR THE PROPOSAL - YES,720474,0,0,1025,1025
TULSA,STATE QUESTION NO. 794 LEGISLATIVE REFERENDUM NO. 371,AGAINST THE PROPOSAL - NO,720474,0,0,238,238
TULSA,STATE QUESTION NO. 794 LEGISLATIVE REFERENDUM NO. 371,FOR THE PROPOSAL - YES,720475,0,0,1231,1231
TULSA,STATE QUESTION NO. 794 LEGISLATIVE REFERENDUM NO. 371,AGAINST THE PROPOSAL - NO,720475,0,0,321,321
TULSA,STATE QUESTION NO. 794 LEGISLATIVE REFERENDUM NO. 371,FOR THE PROPOSAL - YES,720476,0,0,447,447
TULSA,STATE QUESTION NO. 794 LEGISLATIVE REFERENDUM NO. 371,AGAINST THE PROPOSAL - NO,720476,0,0,119,119
TULSA,STATE QUESTION NO. 794 LEGISLATIVE REFERENDUM NO. 371,FOR THE PROPOSAL - YES,720501,0,0,511,511
TULSA,STATE QUESTION NO. 794 LEGISLATIVE REFERENDUM NO. 371,AGAINST THE PROPOSAL - NO,720501,0,0,130,130
TULSA,STATE QUESTION NO. 794 LEGISLATIVE REFERENDUM NO. 371,FOR THE PROPOSAL - YES,720502,0,0,963,963
TULSA,STATE QUESTION NO. 794 LEGISLATIVE REFERENDUM NO. 371,AGAINST THE PROPOSAL - NO,720502,0,0,256,256
TULSA,STATE QUESTION NO. 794 LEGISLATIVE REFERENDUM NO. 371,FOR THE PROPOSAL - YES,720503,0,0,567,567
TULSA,STATE QUESTION NO. 794 LEGISLATIVE REFERENDUM NO. 371,AGAINST THE PROPOSAL - NO,720503,0,0,147,147
TULSA,STATE QUESTION NO. 794 LEGISLATIVE REFERENDUM NO. 371,FOR THE PROPOSAL - YES,720504,0,0,725,725
TULSA,STATE QUESTION NO. 794 LEGISLATIVE REFERENDUM NO. 371,AGAINST THE PROPOSAL - NO,720504,0,0,218,218
TULSA,STATE QUESTION NO. 794 LEGISLATIVE REFERENDUM NO. 371,FOR THE PROPOSAL - YES,720551,0,0,201,201
TULSA,STATE QUESTION NO. 794 LEGISLATIVE REFERENDUM NO. 371,AGAINST THE PROPOSAL - NO,720551,0,0,30,30
TULSA,STATE QUESTION NO. 794 LEGISLATIVE REFERENDUM NO. 371,FOR THE PROPOSAL - YES,720552,0,0,356,356
TULSA,STATE QUESTION NO. 794 LEGISLATIVE REFERENDUM NO. 371,AGAINST THE PROPOSAL - NO,720552,0,0,85,85
TULSA,STATE QUESTION NO. 794 LEGISLATIVE REFERENDUM NO. 371,FOR THE PROPOSAL - YES,720553,0,0,200,200
TULSA,STATE QUESTION NO. 794 LEGISLATIVE REFERENDUM NO. 371,AGAINST THE PROPOSAL - NO,720553,0,0,47,47
TULSA,STATE QUESTION NO. 794 LEGISLATIVE REFERENDUM NO. 371,FOR THE PROPOSAL - YES,720700,0,0,952,952
TULSA,STATE QUESTION NO. 794 LEGISLATIVE REFERENDUM NO. 371,AGAINST THE PROPOSAL - NO,720700,0,0,297,297
TULSA,STATE QUESTION NO. 794 LEGISLATIVE REFERENDUM NO. 371,FOR THE PROPOSAL - YES,720701,0,0,1025,1025
TULSA,STATE QUESTION NO. 794 LEGISLATIVE REFERENDUM NO. 371,AGAINST THE PROPOSAL - NO,720701,0,0,343,343
TULSA,STATE QUESTION NO. 794 LEGISLATIVE REFERENDUM NO. 371,FOR THE PROPOSAL - YES,720702,0,0,557,557
TULSA,STATE QUESTION NO. 794 LEGISLATIVE REFERENDUM NO. 371,AGAINST THE PROPOSAL - NO,720702,0,0,157,157
TULSA,STATE QUESTION NO. 794 LEGISLATIVE REFERENDUM NO. 371,FOR THE PROPOSAL - YES,720703,0,0,1126,1126
TULSA,STATE QUESTION NO. 794 LEGISLATIVE REFERENDUM NO. 371,AGAINST THE PROPOSAL - NO,720703,0,0,350,350
TULSA,STATE QUESTION NO. 794 LEGISLATIVE REFERENDUM NO. 371,FOR THE PROPOSAL - YES,720704,0,0,1208,1208
TULSA,STATE QUESTION NO. 794 LEGISLATIVE REFERENDUM NO. 371,AGAINST THE PROPOSAL - NO,720704,0,0,359,359
TULSA,STATE QUESTION NO. 794 LEGISLATIVE REFERENDUM NO. 371,FOR THE PROPOSAL - YES,720705,0,0,654,654
TULSA,STATE QUESTION NO. 794 LEGISLATIVE REFERENDUM NO. 371,AGAINST THE PROPOSAL - NO,720705,0,0,155,155
TULSA,STATE QUESTION NO. 794 LEGISLATIVE REFERENDUM NO. 371,FOR THE PROPOSAL - YES,720706,0,0,1166,1166
TULSA,STATE QUESTION NO. 794 LEGISLATIVE REFERENDUM NO. 371,AGAINST THE PROPOSAL - NO,720706,0,0,311,311
TULSA,STATE QUESTION NO. 794 LEGISLATIVE REFERENDUM NO. 371,FOR THE PROPOSAL - YES,720707,0,0,536,536
TULSA,STATE QUESTION NO. 794 LEGISLATIVE REFERENDUM NO. 371,AGAINST THE PROPOSAL - NO,720707,0,0,160,160
TULSA,STATE QUESTION NO. 794 LEGISLATIVE REFERENDUM NO. 371,FOR THE PROPOSAL - YES,720708,0,0,640,640
TULSA,STATE QUESTION NO. 794 LEGISLATIVE REFERENDUM NO. 371,AGAINST THE PROPOSAL - NO,720708,0,0,166,166
TULSA,STATE QUESTION NO. 794 LEGISLATIVE REFERENDUM NO. 371,FOR THE PROPOSAL - YES,720709,0,0,767,767
TULSA,STATE QUESTION NO. 794 LEGISLATIVE REFERENDUM NO. 371,AGAINST THE PROPOSAL - NO,720709,0,0,234,234
TULSA,STATE QUESTION NO. 794 LEGISLATIVE REFERENDUM NO. 371,FOR THE PROPOSAL - YES,720710,0,0,254,254
TULSA,STATE QUESTION NO. 794 LEGISLATIVE REFERENDUM NO. 371,AGAINST THE PROPOSAL - NO,720710,0,0,47,47
TULSA,STATE QUESTION NO. 794 LEGISLATIVE REFERENDUM NO. 371,FOR THE PROPOSAL - YES,720750,0,0,797,797
TULSA,STATE QUESTION NO. 794 LEGISLATIVE REFERENDUM NO. 371,AGAINST THE PROPOSAL - NO,720750,0,0,184,184
TULSA,STATE QUESTION NO. 794 LEGISLATIVE REFERENDUM NO. 371,FOR THE PROPOSAL - YES,720751,0,0,948,948
TULSA,STATE QUESTION NO. 794 LEGISLATIVE REFERENDUM NO. 371,AGAINST THE PROPOSAL - NO,720751,0,0,239,239
TULSA,STATE QUESTION NO. 794 LEGISLATIVE REFERENDUM NO. 371,FOR THE PROPOSAL - YES,720752,0,0,799,799
TULSA,STATE QUESTION NO. 794 LEGISLATIVE REFERENDUM NO. 371,AGAINST THE PROPOSAL - NO,720752,0,0,179,179
TULSA,STATE QUESTION NO. 794 LEGISLATIVE REFERENDUM NO. 371,FOR THE PROPOSAL - YES,720753,0,0,497,497
TULSA,STATE QUESTION NO. 794 LEGISLATIVE REFERENDUM NO. 371,AGAINST THE PROPOSAL - NO,720753,0,0,145,145
TULSA,STATE QUESTION NO. 794 LEGISLATIVE REFERENDUM NO. 371,FOR THE PROPOSAL - YES,720754,0,0,978,978
TULSA,STATE QUESTION NO. 794 LEGISLATIVE REFERENDUM NO. 371,AGAINST THE PROPOSAL - NO,720754,0,0,222,222
TULSA,STATE QUESTION NO. 794 LEGISLATIVE REFERENDUM NO. 371,FOR THE PROPOSAL - YES,720755,0,0,1358,1358
TULSA,STATE QUESTION NO. 794 LEGISLATIVE REFERENDUM NO. 371,AGAINST THE PROPOSAL - NO,720755,0,0,402,402
TULSA,STATE QUESTION NO. 794 LEGISLATIVE REFERENDUM NO. 371,FOR THE PROPOSAL - YES,720756,0,0,46,46
TULSA,STATE QUESTION NO. 794 LEGISLATIVE REFERENDUM NO. 371,AGAINST THE PROPOSAL - NO,720756,0,0,16,16
TULSA,STATE QUESTION NO. 794 LEGISLATIVE REFERENDUM NO. 371,FOR THE PROPOSAL - YES,720757,0,0,1384,1384
TULSA,STATE QUESTION NO. 794 LEGISLATIVE REFERENDUM NO. 371,AGAINST THE PROPOSAL - NO,720757,0,0,350,350
TULSA,STATE QUESTION NO. 794 LEGISLATIVE REFERENDUM NO. 371,FOR THE PROPOSAL - YES,720758,0,0,412,412
TULSA,STATE QUESTION NO. 794 LEGISLATIVE REFERENDUM NO. 371,AGAINST THE PROPOSAL - NO,720758,0,0,93,93
TULSA,STATE QUESTION NO. 794 LEGISLATIVE REFERENDUM NO. 371,FOR THE PROPOSAL - YES,720759,0,0,773,773
TULSA,STATE QUESTION NO. 794 LEGISLATIVE REFERENDUM NO. 371,AGAINST THE PROPOSAL - NO,720759,0,0,198,198
TULSA,STATE QUESTION NO. 794 LEGISLATIVE REFERENDUM NO. 371,FOR THE PROPOSAL - YES,720760,0,0,702,702
TULSA,STATE QUESTION NO. 794 LEGISLATIVE REFERENDUM NO. 371,AGAINST THE PROPOSAL - NO,720760,0,0,250,250
TULSA,STATE QUESTION NO. 794 LEGISLATIVE REFERENDUM NO. 371,FOR THE PROPOSAL - YES,720801,0,0,515,515
TULSA,STATE QUESTION NO. 794 LEGISLATIVE REFERENDUM NO. 371,AGAINST THE PROPOSAL - NO,720801,0,0,136,136
TULSA,STATE QUESTION NO. 794 LEGISLATIVE REFERENDUM NO. 371,FOR THE PROPOSAL - YES,720802,0,0,356,356
TULSA,STATE QUESTION NO. 794 LEGISLATIVE REFERENDUM NO. 371,AGAINST THE PROPOSAL - NO,720802,0,0,70,70
TULSA,STATE QUESTION NO. 794 LEGISLATIVE REFERENDUM NO. 371,FOR THE PROPOSAL - YES,720851,0,0,566,566
TULSA,STATE QUESTION NO. 794 LEGISLATIVE REFERENDUM NO. 371,AGAINST THE PROPOSAL - NO,720851,0,0,169,169
TULSA,STATE QUESTION NO. 794 LEGISLATIVE REFERENDUM NO. 371,FOR THE PROPOSAL - YES,720852,0,0,390,390
TULSA,STATE QUESTION NO. 794 LEGISLATIVE REFERENDUM NO. 371,AGAINST THE PROPOSAL - NO,720852,0,0,110,110
TULSA,STATE QUESTION NO. 794 LEGISLATIVE REFERENDUM NO. 371,FOR THE PROPOSAL - YES,720853,0,0,458,458
TULSA,STATE QUESTION NO. 794 LEGISLATIVE REFERENDUM NO. 371,AGAINST THE PROPOSAL - NO,720853,0,0,120,120
TULSA,STATE QUESTION NO. 794 LEGISLATIVE REFERENDUM NO. 371,FOR THE PROPOSAL - YES,720854,0,0,938,938
TULSA,STATE QUESTION NO. 794 LEGISLATIVE REFERENDUM NO. 371,AGAINST THE PROPOSAL - NO,720854,0,0,279,279
TULSA,STATE QUESTION NO. 794 LEGISLATIVE REFERENDUM NO. 371,FOR THE PROPOSAL - YES,720855,0,0,910,910
TULSA,STATE QUESTION NO. 794 LEGISLATIVE REFERENDUM NO. 371,AGAINST THE PROPOSAL - NO,720855,0,0,224,224
TULSA,STATE QUESTION NO. 794 LEGISLATIVE REFERENDUM NO. 371,FOR THE PROPOSAL - YES,720856,0,0,1019,1019
TULSA,STATE QUESTION NO. 794 LEGISLATIVE REFERENDUM NO. 371,AGAINST THE PROPOSAL - NO,720856,0,0,246,246
TULSA,STATE QUESTION NO. 794 LEGISLATIVE REFERENDUM NO. 371,FOR THE PROPOSAL - YES,720857,0,0,585,585
TULSA,STATE QUESTION NO. 794 LEGISLATIVE REFERENDUM NO. 371,AGAINST THE PROPOSAL - NO,720857,0,0,158,158
TULSA,STATE QUESTION NO. 794 LEGISLATIVE REFERENDUM NO. 371,FOR THE PROPOSAL - YES,720858,0,0,332,332
TULSA,STATE QUESTION NO. 794 LEGISLATIVE REFERENDUM NO. 371,AGAINST THE PROPOSAL - NO,720858,0,0,84,84
TULSA,STATE QUESTION NO. 794 LEGISLATIVE REFERENDUM NO. 371,FOR THE PROPOSAL - YES,720880,0,0,731,731
TULSA,STATE QUESTION NO. 794 LEGISLATIVE REFERENDUM NO. 371,AGAINST THE PROPOSAL - NO,720880,0,0,185,185
TULSA,STATE QUESTION NO. 794 LEGISLATIVE REFERENDUM NO. 371,FOR THE PROPOSAL - YES,720881,0,0,525,525
TULSA,STATE QUESTION NO. 794 LEGISLATIVE REFERENDUM NO. 371,AGAINST THE PROPOSAL - NO,720881,0,0,127,127
TULSA,STATE QUESTION NO. 794 LEGISLATIVE REFERENDUM NO. 371,FOR THE PROPOSAL - YES,720900,0,0,901,901
TULSA,STATE QUESTION NO. 794 LEGISLATIVE REFERENDUM NO. 371,AGAINST THE PROPOSAL - NO,720900,0,0,209,209
TULSA,STATE QUESTION NO. 794 LEGISLATIVE REFERENDUM NO. 371,FOR THE PROPOSAL - YES,729999,7754,9698,0,17452
TULSA,STATE QUESTION NO. 794 LEGISLATIVE REFERENDUM NO. 371,AGAINST THE PROPOSAL - NO,729999,2013,2909,0,4922
WAGONER,STATE QUESTION NO. 794 LEGISLATIVE REFERENDUM NO. 371,FOR THE PROPOSAL - YES,730101,9,23,478,510
WAGONER,STATE QUESTION NO. 794 LEGISLATIVE REFERENDUM NO. 371,AGAINST THE PROPOSAL - NO,730101,3,2,101,106
WAGONER,STATE QUESTION NO. 794 LEGISLATIVE REFERENDUM NO. 371,FOR THE PROPOSAL - YES,730102,17,33,550,600
WAGONER,STATE QUESTION NO. 794 LEGISLATIVE REFERENDUM NO. 371,AGAINST THE PROPOSAL - NO,730102,4,6,118,128
WAGONER,STATE QUESTION NO. 794 LEGISLATIVE REFERENDUM NO. 371,FOR THE PROPOSAL - YES,730103,43,110,1148,1301
WAGONER,STATE QUESTION NO. 794 LEGISLATIVE REFERENDUM NO. 371,AGAINST THE PROPOSAL - NO,730103,11,35,303,349
WAGONER,STATE QUESTION NO. 794 LEGISLATIVE REFERENDUM NO. 371,FOR THE PROPOSAL - YES,730104,0,0,0,0
WAGONER,STATE QUESTION NO. 794 LEGISLATIVE REFERENDUM NO. 371,AGAINST THE PROPOSAL - NO,730104,0,0,0,0
WAGONER,STATE QUESTION NO. 794 LEGISLATIVE REFERENDUM NO. 371,FOR THE PROPOSAL - YES,730105,0,0,6,6
WAGONER,STATE QUESTION NO. 794 LEGISLATIVE REFERENDUM NO. 371,AGAINST THE PROPOSAL - NO,730105,0,0,0,0
WAGONER,STATE QUESTION NO. 794 LEGISLATIVE REFERENDUM NO. 371,FOR THE PROPOSAL - YES,730106,54,178,1077,1309
WAGONER,STATE QUESTION NO. 794 LEGISLATIVE REFERENDUM NO. 371,AGAINST THE PROPOSAL - NO,730106,14,35,282,331
WAGONER,STATE QUESTION NO. 794 LEGISLATIVE REFERENDUM NO. 371,FOR THE PROPOSAL - YES,730107,59,280,891,1230
WAGONER,STATE QUESTION NO. 794 LEGISLATIVE REFERENDUM NO. 371,AGAINST THE PROPOSAL - NO,730107,4,46,186,236
WAGONER,STATE QUESTION NO. 794 LEGISLATIVE REFERENDUM NO. 371,FOR THE PROPOSAL - YES,730108,32,119,550,701
WAGONER,STATE QUESTION NO. 794 LEGISLATIVE REFERENDUM NO. 371,AGAINST THE PROPOSAL - NO,730108,10,18,141,169
WAGONER,STATE QUESTION NO. 794 LEGISLATIVE REFERENDUM NO. 371,FOR THE PROPOSAL - YES,730109,36,127,625,788
WAGONER,STATE QUESTION NO. 794 LEGISLATIVE REFERENDUM NO. 371,AGAINST THE PROPOSAL - NO,730109,8,27,127,162
WAGONER,STATE QUESTION NO. 794 LEGISLATIVE REFERENDUM NO. 371,FOR THE PROPOSAL - YES,730201,26,46,704,776
WAGONER,STATE QUESTION NO. 794 LEGISLATIVE REFERENDUM NO. 371,AGAINST THE PROPOSAL - NO,730201,9,19,193,221
WAGONER,STATE QUESTION NO. 794 LEGISLATIVE REFERENDUM NO. 371,FOR THE PROPOSAL - YES,730202,29,51,834,914
WAGONER,STATE QUESTION NO. 794 LEGISLATIVE REFERENDUM NO. 371,AGAINST THE PROPOSAL - NO,730202,8,13,202,223
WAGONER,STATE QUESTION NO. 794 LEGISLATIVE REFERENDUM NO. 371,FOR THE PROPOSAL - YES,730203,17,158,745,920
WAGONER,STATE QUESTION NO. 794 LEGISLATIVE REFERENDUM NO. 371,AGAINST THE PROPOSAL - NO,730203,5,39,202,246
WAGONER,STATE QUESTION NO. 794 LEGISLATIVE REFERENDUM NO. 371,FOR THE PROPOSAL - YES,730204,13,56,509,578
WAGONER,STATE QUESTION NO. 794 LEGISLATIVE REFERENDUM NO. 371,AGAINST THE PROPOSAL - NO,730204,8,9,100,117
WAGONER,STATE QUESTION NO. 794 LEGISLATIVE REFERENDUM NO. 371,FOR THE PROPOSAL - YES,730205,4,13,73,90
WAGONER,STATE QUESTION NO. 794 LEGISLATIVE REFERENDUM NO. 371,AGAINST THE PROPOSAL - NO,730205,0,6,35,41
WAGONER,STATE QUESTION NO. 794 LEGISLATIVE REFERENDUM NO. 371,FOR THE PROPOSAL - YES,730206,0,2,34,36
WAGONER,STATE QUESTION NO. 794 LEGISLATIVE REFERENDUM NO. 371,AGAINST THE PROPOSAL - NO,730206,0,0,9,9
WAGONER,STATE QUESTION NO. 794 LEGISLATIVE REFERENDUM NO. 371,FOR THE PROPOSAL - YES,730207,4,28,246,278
WAGONER,STATE QUESTION NO. 794 LEGISLATIVE REFERENDUM NO. 371,AGAINST THE PROPOSAL - NO,730207,0,6,75,81
WAGONER,STATE QUESTION NO. 794 LEGISLATIVE REFERENDUM NO. 371,FOR THE PROPOSAL - YES,730208,23,235,938,1196
WAGONER,STATE QUESTION NO. 794 LEGISLATIVE REFERENDUM NO. 371,AGAINST THE PROPOSAL - NO,730208,4,58,220,282
WAGONER,STATE QUESTION NO. 794 LEGISLATIVE REFERENDUM NO. 371,FOR THE PROPOSAL - YES,730209,10,41,242,293
WAGONER,STATE QUESTION NO. 794 LEGISLATIVE REFERENDUM NO. 371,AGAINST THE PROPOSAL - NO,730209,0,6,58,64
WAGONER,STATE QUESTION NO. 794 LEGISLATIVE REFERENDUM NO. 371,FOR THE PROPOSAL - YES,730210,16,76,674,766
WAGONER,STATE QUESTION NO. 794 LEGISLATIVE REFERENDUM NO. 371,AGAINST THE PROPOSAL - NO,730210,6,22,184,212
WAGONER,STATE QUESTION NO. 794 LEGISLATIVE REFERENDUM NO. 371,FOR THE PROPOSAL - YES,730301,38,187,735,960
WAGONER,STATE QUESTION NO. 794 LEGISLATIVE REFERENDUM NO. 371,AGAINST THE PROPOSAL - NO,730301,10,44,196,250
WAGONER,STATE QUESTION NO. 794 LEGISLATIVE REFERENDUM NO. 371,FOR THE PROPOSAL - YES,730302,67,446,734,1247
WAGONER,STATE QUESTION NO. 794 LEGISLATIVE REFERENDUM NO. 371,AGAINST THE PROPOSAL - NO,730302,21,79,166,266
WAGONER,STATE QUESTION NO. 794 LEGISLATIVE REFERENDUM NO. 371,FOR THE PROPOSAL - YES,730303,17,116,383,516
WAGONER,STATE QUESTION NO. 794 LEGISLATIVE REFERENDUM NO. 371,AGAINST THE PROPOSAL - NO,730303,7,14,94,115
WAGONER,STATE QUESTION NO. 794 LEGISLATIVE REFERENDUM NO. 371,FOR THE PROPOSAL - YES,730304,25,67,667,759
WAGONER,STATE QUESTION NO. 794 LEGISLATIVE REFERENDUM NO. 371,AGAINST THE PROPOSAL - NO,730304,5,17,188,210
WAGONER,STATE QUESTION NO. 794 LEGISLATIVE REFERENDUM NO. 371,FOR THE PROPOSAL - YES,730305,3,9,68,80
WAGONER,STATE QUESTION NO. 794 LEGISLATIVE REFERENDUM NO. 371,AGAINST THE PROPOSAL - NO,730305,2,0,18,20
WAGONER,STATE QUESTION NO. 794 LEGISLATIVE REFERENDUM NO. 371,FOR THE PROPOSAL - YES,730306,55,118,926,1099
WAGONER,STATE QUESTION NO. 794 LEGISLATIVE REFERENDUM NO. 371,AGAINST THE PROPOSAL - NO,730306,9,20,223,252
WAGONER,STATE QUESTION NO. 794 LEGISLATIVE REFERENDUM NO. 371,FOR THE PROPOSAL - YES,730307,32,82,644,758
WAGONER,STATE QUESTION NO. 794 LEGISLATIVE REFERENDUM NO. 371,AGAINST THE PROPOSAL - NO,730307,8,9,183,200
WAGONER,STATE QUESTION NO. 794 LEGISLATIVE REFERENDUM NO. 371,FOR THE PROPOSAL - YES,730308,27,38,593,658
WAGONER,STATE QUESTION NO. 794 LEGISLATIVE REFERENDUM NO. 371,AGAINST THE PROPOSAL - NO,730308,5,8,165,178
WAGONER,STATE QUESTION NO. 794 LEGISLATIVE REFERENDUM NO. 371,FOR THE PROPOSAL - YES,730309,19,40,685,744
WAGONER,STATE QUESTION NO. 794 LEGISLATIVE REFERENDUM NO. 371,AGAINST THE PROPOSAL - NO,730309,5,5,162,172
WAGONER,STATE QUESTION NO. 794 LEGISLATIVE REFERENDUM NO. 371,FOR THE PROPOSAL - YES,730310,9,8,298,315
WAGONER,STATE QUESTION NO. 794 LEGISLATIVE REFERENDUM NO. 371,AGAINST THE PROPOSAL - NO,730310,1,4,72,77
WAGONER,STATE QUESTION NO. 794 LEGISLATIVE REFERENDUM NO. 371,FOR THE PROPOSAL - YES,730311,3,5,162,170
WAGONER,STATE QUESTION NO. 794 LEGISLATIVE REFERENDUM NO. 371,AGAINST THE PROPOSAL - NO,730311,3,3,55,61
WAGONER,STATE QUESTION NO. 794 LEGISLATIVE REFERENDUM NO. 371,FOR THE PROPOSAL - YES,730312,22,53,506,581
WAGONER,STATE QUESTION NO. 794 LEGISLATIVE REFERENDUM NO. 371,AGAINST THE PROPOSAL - NO,730312,5,14,147,166
WAGONER,STATE QUESTION NO. 794 LEGISLATIVE REFERENDUM NO. 371,FOR THE PROPOSAL - YES,730313,12,20,210,242
WAGONER,STATE QUESTION NO. 794 LEGISLATIVE REFERENDUM NO. 371,AGAINST THE PROPOSAL - NO,730313,0,3,68,71
WASHINGTON,STATE QUESTION NO. 794 LEGISLATIVE REFERENDUM NO. 371,FOR THE PROPOSAL - YES,740011,22,79,501,602
WASHINGTON,STATE QUESTION NO. 794 LEGISLATIVE REFERENDUM NO. 371,AGAINST THE PROPOSAL - NO,740011,5,30,165,200
WASHINGTON,STATE QUESTION NO. 794 LEGISLATIVE REFERENDUM NO. 371,FOR THE PROPOSAL - YES,740012,5,28,148,181
WASHINGTON,STATE QUESTION NO. 794 LEGISLATIVE REFERENDUM NO. 371,AGAINST THE PROPOSAL - NO,740012,2,5,30,37
WASHINGTON,STATE QUESTION NO. 794 LEGISLATIVE REFERENDUM NO. 371,FOR THE PROPOSAL - YES,740013,12,40,547,599
WASHINGTON,STATE QUESTION NO. 794 LEGISLATIVE REFERENDUM NO. 371,AGAINST THE PROPOSAL - NO,740013,2,14,127,143
WASHINGTON,STATE QUESTION NO. 794 LEGISLATIVE REFERENDUM NO. 371,FOR THE PROPOSAL - YES,740015,17,87,617,721
WASHINGTON,STATE QUESTION NO. 794 LEGISLATIVE REFERENDUM NO. 371,AGAINST THE PROPOSAL - NO,740015,4,19,171,194
WASHINGTON,STATE QUESTION NO. 794 LEGISLATIVE REFERENDUM NO. 371,FOR THE PROPOSAL - YES,740022,61,264,1131,1456
WASHINGTON,STATE QUESTION NO. 794 LEGISLATIVE REFERENDUM NO. 371,AGAINST THE PROPOSAL - NO,740022,34,124,351,509
WASHINGTON,STATE QUESTION NO. 794 LEGISLATIVE REFERENDUM NO. 371,FOR THE PROPOSAL - YES,740027,13,30,255,298
WASHINGTON,STATE QUESTION NO. 794 LEGISLATIVE REFERENDUM NO. 371,AGAINST THE PROPOSAL - NO,740027,2,17,88,107
WASHINGTON,STATE QUESTION NO. 794 LEGISLATIVE REFERENDUM NO. 371,FOR THE PROPOSAL - YES,740028,58,219,1238,1515
WASHINGTON,STATE QUESTION NO. 794 LEGISLATIVE REFERENDUM NO. 371,AGAINST THE PROPOSAL - NO,740028,21,75,336,432
WASHINGTON,STATE QUESTION NO. 794 LEGISLATIVE REFERENDUM NO. 371,FOR THE PROPOSAL - YES,740031,45,153,893,1091
WASHINGTON,STATE QUESTION NO. 794 LEGISLATIVE REFERENDUM NO. 371,AGAINST THE PROPOSAL - NO,740031,16,50,296,362
WASHINGTON,STATE QUESTION NO. 794 LEGISLATIVE REFERENDUM NO. 371,FOR THE PROPOSAL - YES,740033,7,23,330,360
WASHINGTON,STATE QUESTION NO. 794 LEGISLATIVE REFERENDUM NO. 371,AGAINST THE PROPOSAL - NO,740033,2,4,71,77
WASHINGTON,STATE QUESTION NO. 794 LEGISLATIVE REFERENDUM NO. 371,FOR THE PROPOSAL - YES,740046,8,7,306,321
WASHINGTON,STATE QUESTION NO. 794 LEGISLATIVE REFERENDUM NO. 371,AGAINST THE PROPOSAL - NO,740046,0,2,67,69
WASHINGTON,STATE QUESTION NO. 794 LEGISLATIVE REFERENDUM NO. 371,FOR THE PROPOSAL - YES,740048,17,37,437,491
WASHINGTON,STATE QUESTION NO. 794 LEGISLATIVE REFERENDUM NO. 371,AGAINST THE PROPOSAL - NO,740048,5,11,109,125
WASHINGTON,STATE QUESTION NO. 794 LEGISLATIVE REFERENDUM NO. 371,FOR THE PROPOSAL - YES,740051,28,102,695,825
WASHINGTON,STATE QUESTION NO. 794 LEGISLATIVE REFERENDUM NO. 371,AGAINST THE PROPOSAL - NO,740051,11,24,188,223
WASHINGTON,STATE QUESTION NO. 794 LEGISLATIVE REFERENDUM NO. 371,FOR THE PROPOSAL - YES,740054,44,90,886,1020
WASHINGTON,STATE QUESTION NO. 794 LEGISLATIVE REFERENDUM NO. 371,AGAINST THE PROPOSAL - NO,740054,13,29,231,273
WASHINGTON,STATE QUESTION NO. 794 LEGISLATIVE REFERENDUM NO. 371,FOR THE PROPOSAL - YES,740062,26,37,678,741
WASHINGTON,STATE QUESTION NO. 794 LEGISLATIVE REFERENDUM NO. 371,AGAINST THE PROPOSAL - NO,740062,19,12,191,222
WASHINGTON,STATE QUESTION NO. 794 LEGISLATIVE REFERENDUM NO. 371,FOR THE PROPOSAL - YES,740071,7,20,576,603
WASHINGTON,STATE QUESTION NO. 794 LEGISLATIVE REFERENDUM NO. 371,AGAINST THE PROPOSAL - NO,740071,1,3,122,126
WASHINGTON,STATE QUESTION NO. 794 LEGISLATIVE REFERENDUM NO. 371,FOR THE PROPOSAL - YES,740073,10,11,305,326
WASHINGTON,STATE QUESTION NO. 794 LEGISLATIVE REFERENDUM NO. 371,AGAINST THE PROPOSAL - NO,740073,2,3,78,83
WASHINGTON,STATE QUESTION NO. 794 LEGISLATIVE REFERENDUM NO. 371,FOR THE PROPOSAL - YES,740074,6,18,273,297
WASHINGTON,STATE QUESTION NO. 794 LEGISLATIVE REFERENDUM NO. 371,AGAINST THE PROPOSAL - NO,740074,4,4,59,67
WASHINGTON,STATE QUESTION NO. 794 LEGISLATIVE REFERENDUM NO. 371,FOR THE PROPOSAL - YES,740075,12,33,384,429
WASHINGTON,STATE QUESTION NO. 794 LEGISLATIVE REFERENDUM NO. 371,AGAINST THE PROPOSAL - NO,740075,7,20,111,138
WASHINGTON,STATE QUESTION NO. 794 LEGISLATIVE REFERENDUM NO. 371,FOR THE PROPOSAL - YES,740076,11,21,303,335
WASHINGTON,STATE QUESTION NO. 794 LEGISLATIVE REFERENDUM NO. 371,AGAINST THE PROPOSAL - NO,740076,0,5,81,86
WASHINGTON,STATE QUESTION NO. 794 LEGISLATIVE REFERENDUM NO. 371,FOR THE PROPOSAL - YES,740077,19,20,493,532
WASHINGTON,STATE QUESTION NO. 794 LEGISLATIVE REFERENDUM NO. 371,AGAINST THE PROPOSAL - NO,740077,4,5,91,100
WASHINGTON,STATE QUESTION NO. 794 LEGISLATIVE REFERENDUM NO. 371,FOR THE PROPOSAL - YES,740078,11,9,398,418
WASHINGTON,STATE QUESTION NO. 794 LEGISLATIVE REFERENDUM NO. 371,AGAINST THE PROPOSAL - NO,740078,6,0,86,92
WASHINGTON,STATE QUESTION NO. 794 LEGISLATIVE REFERENDUM NO. 371,FOR THE PROPOSAL - YES,740079,9,10,395,414
WASHINGTON,STATE QUESTION NO. 794 LEGISLATIVE REFERENDUM NO. 371,AGAINST THE PROPOSAL - NO,740079,3,6,100,109
WASHINGTON,STATE QUESTION NO. 794 LEGISLATIVE REFERENDUM NO. 371,FOR THE PROPOSAL - YES,740711,5,21,91,117
WASHINGTON,STATE QUESTION NO. 794 LEGISLATIVE REFERENDUM NO. 371,AGAINST THE PROPOSAL - NO,740711,3,10,30,43
WASHITA,STATE QUESTION NO. 794 LEGISLATIVE REFERENDUM NO. 371,FOR THE PROPOSAL - YES,750003,10,3,85,98
WASHITA,STATE QUESTION NO. 794 LEGISLATIVE REFERENDUM NO. 371,AGAINST THE PROPOSAL - NO,750003,1,0,19,20
WASHITA,STATE QUESTION NO. 794 LEGISLATIVE REFERENDUM NO. 371,FOR THE PROPOSAL - YES,750004,31,83,438,552
WASHITA,STATE QUESTION NO. 794 LEGISLATIVE REFERENDUM NO. 371,AGAINST THE PROPOSAL - NO,750004,8,27,131,166
WASHITA,STATE QUESTION NO. 794 LEGISLATIVE REFERENDUM NO. 371,FOR THE PROPOSAL - YES,750007,7,9,192,208
WASHITA,STATE QUESTION NO. 794 LEGISLATIVE REFERENDUM NO. 371,AGAINST THE PROPOSAL - NO,750007,2,2,70,74
WASHITA,STATE QUESTION NO. 794 LEGISLATIVE REFERENDUM NO. 371,FOR THE PROPOSAL - YES,750009,1,9,146,156
WASHITA,STATE QUESTION NO. 794 LEGISLATIVE REFERENDUM NO. 371,AGAINST THE PROPOSAL - NO,750009,2,7,34,43
WASHITA,STATE QUESTION NO. 794 LEGISLATIVE REFERENDUM NO. 371,FOR THE PROPOSAL - YES,750012,9,5,155,169
WASHITA,STATE QUESTION NO. 794 LEGISLATIVE REFERENDUM NO. 371,AGAINST THE PROPOSAL - NO,750012,1,1,40,42
WASHITA,STATE QUESTION NO. 794 LEGISLATIVE REFERENDUM NO. 371,FOR THE PROPOSAL - YES,750014,16,3,322,341
WASHITA,STATE QUESTION NO. 794 LEGISLATIVE REFERENDUM NO. 371,AGAINST THE PROPOSAL - NO,750014,4,2,120,126
WASHITA,STATE QUESTION NO. 794 LEGISLATIVE REFERENDUM NO. 371,FOR THE PROPOSAL - YES,750016,20,13,292,325
WASHITA,STATE QUESTION NO. 794 LEGISLATIVE REFERENDUM NO. 371,AGAINST THE PROPOSAL - NO,750016,6,6,97,109
WASHITA,STATE QUESTION NO. 794 LEGISLATIVE REFERENDUM NO. 371,FOR THE PROPOSAL - YES,750017,2,3,152,157
WASHITA,STATE QUESTION NO. 794 LEGISLATIVE REFERENDUM NO. 371,AGAINST THE PROPOSAL - NO,750017,0,1,48,49
WASHITA,STATE QUESTION NO. 794 LEGISLATIVE REFERENDUM NO. 371,FOR THE PROPOSAL - YES,750018,9,8,151,168
WASHITA,STATE QUESTION NO. 794 LEGISLATIVE REFERENDUM NO. 371,AGAINST THE PROPOSAL - NO,750018,1,6,44,51
WASHITA,STATE QUESTION NO. 794 LEGISLATIVE REFERENDUM NO. 371,FOR THE PROPOSAL - YES,750019,9,9,238,256
WASHITA,STATE QUESTION NO. 794 LEGISLATIVE REFERENDUM NO. 371,AGAINST THE PROPOSAL - NO,750019,4,7,104,115
WASHITA,STATE QUESTION NO. 794 LEGISLATIVE REFERENDUM NO. 371,FOR THE PROPOSAL - YES,750020,7,2,133,142
WASHITA,STATE QUESTION NO. 794 LEGISLATIVE REFERENDUM NO. 371,AGAINST THE PROPOSAL - NO,750020,1,0,38,39
WASHITA,STATE QUESTION NO. 794 LEGISLATIVE REFERENDUM NO. 371,FOR THE PROPOSAL - YES,750030,13,36,209,258
WASHITA,STATE QUESTION NO. 794 LEGISLATIVE REFERENDUM NO. 371,AGAINST THE PROPOSAL - NO,750030,6,7,60,73
WOODS,STATE QUESTION NO. 794 LEGISLATIVE REFERENDUM NO. 371,FOR THE PROPOSAL - YES,760001,19,124,449,592
WOODS,STATE QUESTION NO. 794 LEGISLATIVE REFERENDUM NO. 371,AGAINST THE PROPOSAL - NO,760001,2,31,144,177
WOODS,STATE QUESTION NO. 794 LEGISLATIVE REFERENDUM NO. 371,FOR THE PROPOSAL - YES,760002,20,19,326,365
WOODS,STATE QUESTION NO. 794 LEGISLATIVE REFERENDUM NO. 371,AGAINST THE PROPOSAL - NO,760002,3,4,83,90
WOODS,STATE QUESTION NO. 794 LEGISLATIVE REFERENDUM NO. 371,FOR THE PROPOSAL - YES,760003,10,44,205,259
WOODS,STATE QUESTION NO. 794 LEGISLATIVE REFERENDUM NO. 371,AGAINST THE PROPOSAL - NO,760003,3,10,43,56
WOODS,STATE QUESTION NO. 794 LEGISLATIVE REFERENDUM NO. 371,FOR THE PROPOSAL - YES,760004,3,13,92,108
WOODS,STATE QUESTION NO. 794 LEGISLATIVE REFERENDUM NO. 371,AGAINST THE PROPOSAL - NO,760004,0,0,25,25
WOODS,STATE QUESTION NO. 794 LEGISLATIVE REFERENDUM NO. 371,FOR THE PROPOSAL - YES,760005,43,145,515,703
WOODS,STATE QUESTION NO. 794 LEGISLATIVE REFERENDUM NO. 371,AGAINST THE PROPOSAL - NO,760005,7,39,169,215
WOODS,STATE QUESTION NO. 794 LEGISLATIVE REFERENDUM NO. 371,FOR THE PROPOSAL - YES,760008,16,8,153,177
WOODS,STATE QUESTION NO. 794 LEGISLATIVE REFERENDUM NO. 371,AGAINST THE PROPOSAL - NO,760008,2,2,37,41
WOODWARD,STATE QUESTION NO. 794 LEGISLATIVE REFERENDUM NO. 371,FOR THE PROPOSAL - YES,770101,9,54,338,401
WOODWARD,STATE QUESTION NO. 794 LEGISLATIVE REFERENDUM NO. 371,AGAINST THE PROPOSAL - NO,770101,2,14,73,89
WOODWARD,STATE QUESTION NO. 794 LEGISLATIVE REFERENDUM NO. 371,FOR THE PROPOSAL - YES,770102,3,25,208,236
WOODWARD,STATE QUESTION NO. 794 LEGISLATIVE REFERENDUM NO. 371,AGAINST THE PROPOSAL - NO,770102,1,10,60,71
WOODWARD,STATE QUESTION NO. 794 LEGISLATIVE REFERENDUM NO. 371,FOR THE PROPOSAL - YES,770104,2,0,2,4
WOODWARD,STATE QUESTION NO. 794 LEGISLATIVE REFERENDUM NO. 371,AGAINST THE PROPOSAL - NO,770104,0,0,0,0
WOODWARD,STATE QUESTION NO. 794 LEGISLATIVE REFERENDUM NO. 371,FOR THE PROPOSAL - YES,770105,11,31,476,518
WOODWARD,STATE QUESTION NO. 794 LEGISLATIVE REFERENDUM NO. 371,AGAINST THE PROPOSAL - NO,770105,8,5,152,165
WOODWARD,STATE QUESTION NO. 794 LEGISLATIVE REFERENDUM NO. 371,FOR THE PROPOSAL - YES,770106,7,3,37,47
WOODWARD,STATE QUESTION NO. 794 LEGISLATIVE REFERENDUM NO. 371,AGAINST THE PROPOSAL - NO,770106,4,0,27,31
WOODWARD,STATE QUESTION NO. 794 LEGISLATIVE REFERENDUM NO. 371,FOR THE PROPOSAL - YES,770201,18,110,440,568
WOODWARD,STATE QUESTION NO. 794 LEGISLATIVE REFERENDUM NO. 371,AGAINST THE PROPOSAL - NO,770201,7,29,134,170
WOODWARD,STATE QUESTION NO. 794 LEGISLATIVE REFERENDUM NO. 371,FOR THE PROPOSAL - YES,770202,17,141,664,822
WOODWARD,STATE QUESTION NO. 794 LEGISLATIVE REFERENDUM NO. 371,AGAINST THE PROPOSAL - NO,770202,3,35,200,238
WOODWARD,STATE QUESTION NO. 794 LEGISLATIVE REFERENDUM NO. 371,FOR THE PROPOSAL - YES,770203,8,29,270,307
WOODWARD,STATE QUESTION NO. 794 LEGISLATIVE REFERENDUM NO. 371,AGAINST THE PROPOSAL - NO,770203,4,7,83,94
WOODWARD,STATE QUESTION NO. 794 LEGISLATIVE REFERENDUM NO. 371,FOR THE PROPOSAL - YES,770204,5,11,123,139
WOODWARD,STATE QUESTION NO. 794 LEGISLATIVE REFERENDUM NO. 371,AGAINST THE PROPOSAL - NO,770204,0,2,26,28
WOODWARD,STATE QUESTION NO. 794 LEGISLATIVE REFERENDUM NO. 371,FOR THE PROPOSAL - YES,770301,4,30,134,168
WOODWARD,STATE QUESTION NO. 794 LEGISLATIVE REFERENDUM NO. 371,AGAINST THE PROPOSAL - NO,770301,1,9,30,40
WOODWARD,STATE QUESTION NO. 794 LEGISLATIVE REFERENDUM NO. 371,FOR THE PROPOSAL - YES,770302,7,46,123,176
WOODWARD,STATE QUESTION NO. 794 LEGISLATIVE REFERENDUM NO. 371,AGAINST THE PROPOSAL - NO,770302,1,8,42,51
WOODWARD,STATE QUESTION NO. 794 LEGISLATIVE REFERENDUM NO. 371,FOR THE PROPOSAL - YES,770303,0,2,0,2
WOODWARD,STATE QUESTION NO. 794 LEGISLATIVE REFERENDUM NO. 371,AGAINST THE PROPOSAL - NO,770303,0,0,0,0
WOODWARD,STATE QUESTION NO. 794 LEGISLATIVE REFERENDUM NO. 371,FOR THE PROPOSAL - YES,770304,4,17,127,148
WOODWARD,STATE QUESTION NO. 794 LEGISLATIVE REFERENDUM NO. 371,AGAINST THE PROPOSAL - NO,770304,0,3,32,35
WOODWARD,STATE QUESTION NO. 794 LEGISLATIVE REFERENDUM NO. 371,FOR THE PROPOSAL - YES,770306,24,161,721,906
WOODWARD,STATE QUESTION NO. 794 LEGISLATIVE REFERENDUM NO. 371,AGAINST THE PROPOSAL - NO,770306,7,55,218,280
WOODWARD,STATE QUESTION NO. 794 LEGISLATIVE REFERENDUM NO. 371,FOR THE PROPOSAL - YES,770307,1,4,78,83
WOODWARD,STATE QUESTION NO. 794 LEGISLATIVE REFERENDUM NO. 371,AGAINST THE PROPOSAL - NO,770307,0,0,25,25
